a	a
abondance	a b o n d a n c e
abonnemènts	a b o n n e m è n t s
acbit	a c b i t
accordeon	a c c o r d e o n
aceton	a c e t o n
acmonica	a c m o n i c a
acquy	a c q uy
acten	a c t e n
adjectif	a d e c t i f
adn	a d n
agide	a gi d e
ai	a i
ainsi	a i n s i
ak	a k
aldehyd	a l d e h y d
allo	a l l o
almicar	a l m i c a r
alo	a l o
am	a m
amian	a m i a n
amib	a m i b
amies	a m i e s
amilcar	a m i l c a r
amip	a m i p
amiral	a m i r a l
amiđan	a m i đ a n
ammoniac	a m m o n i a c
amours	a m o u r s
ampe	a m p e
ampli	a m p l i
an	a n
anbom	a n b o m
anbum	a n b u m
ancaloit	a n c a l o i t
ang	a ng
angkor	a ng k o r
angorit	a ng o r i t
anh	a nh
anis	a n i s
anmanac	a n m a n a c
anod	a n o d
anofen	a n o f e n
anormal	a n o r m a l
anot	a n o t
anpha	a n ph a
anquetil	a n q u e t i l
anten	a n t e n
antimon	a n t i m o n
antipirin	a n t i p i r i n
antole	a n t o l e
antraxit	a n tr a x i t
anđehit	a n đ e h i t
ao	a o
aon	a o n
apacthai	a p a c th a i
apatit	a p a t i t
apip	a p i p
apphe	a p ph e
apphich	a p ph i ch
apxe	a p x e
arbit	a r b i t
armonica	a r m o n i c a
arrivetoujours	a r r i v e t o u o u r s
artel	a r t e l
asen	a s e n
asseztôt	a s s e z t ô t
at	a t
atk	a t k
atropin	a tr o p i n
au	a u
autant	a u t a n t
automat	a u t o m a t
autres	a u tr e s
avaient	a v a i e n t
avec	a v e c
avion	a v i o n
axetic	a x e t i c
axetilen	a x e t i l e n
axeton	a x e t o n
axit	a x i t
ay	a y
ayun	a y u n
azot	a z o t
aỏi	a ỏ i
aỏn	a ỏ n
ba	b a
badôca	b a d ô c a
bai	b a i
bainville	b a i n v i l l e
bakelit	b a k e l i t
balat	b a l a t
balông	b a l ô ng
bam	b a m
ban	b a n
bancông	b a n c ô ng
bang	b a ng
banh	b a nh
bao	b a o
barem	b a r e m
baren	b a r e n
barie	b a r i e
barrès	b a r r è s
barthou	b a r th o u
bas	b a s
basoi	b a s o i
bata	b a t a
batoong	b a t oo ng
batumi	b a t u m i
bau	b a u
baudelaire	b a u d e l a i r e
bay	b a y
bch	b ch
bct	b c t
be	b e
bem	b e m
ben	b e n
beng	b e ng
benzen	b e n z e n
beo	b e o
bergères	b e r g è r e s
beri	b e r i
besoin	b e s o i n
bhing	b h i ng
bi	b i
bia	b i a
bianes	b i a n e s
bic	b i c
bichcôt	b i ch c ô t
bichepin	b i ch e p i n
bida	b i d a
bih	b i h
bin	b i n
binh	b i nh
binđinh	b i n đ i nh
biptêt	b i p t ê t
bismut	b i s m u t
bitcôt	b i t c ô t
bitum	b i t u m
biên	b iê n
biêng	b iê ng
biêt	b iê t
biêu	b iê u
biếc	b iế c
biếm	b iế m
biến	b iế n
biếng	b iế ng
biết	b iế t
biếu	b iế u
biền	b iề n
biều	b iề u
biển	b iể n
biểu	b iể u
biện	b iệ n
biệt	b iệ t
blu	b l u
blummoutet	b l u m m o u t e t
blông	b l ô ng
blốc	b l ố c
bo	b o
boa	b oa
bobin	b o b i n
boliviano	b o l i v i a n o
bom	b o m
bombes	b o m b e s
bon	b o n
bong	b o ng
bonheur	b o nh e u r
boniface	b o n i f a c e
bonnal	b o n n a l
bonnéte	b o n n é t e
bonsevich	b o n s e v i ch
bonsoir	b o n s o i r
booc	b oo c
boong	b oo ng
boongke	b oo ng k e
boà	b oà
boát	b oá t
boóc	b oó c
boóng	b oó ng
br	b r
brabahol	b r a b a h o l
braian	b r a i a n
brao	b r a o
briseni	b r i s e n i
bromua	b r o m u a
bru	b r u
brâu	b r â u
brôm	b r ô m
bs	b s
bu	b u
bua	b u a
bugi	b u gi
bui	b u i
buji	b u i
bulông	b u l ô ng
bum	b u m
bun	b u n
bung	b u ng
buy	b uy
buôi	b uô i
buôn	b uô n
buông	b uô ng
buýp	b uý p
buýt	b uý t
buốt	b uố t
buồi	b uồ i
buồm	b uồ m
buồn	b uồ n
buồng	b uồ ng
buổi	b uổ i
buộc	b uộ c
buộm	b uộ m
buột	b uộ t
bà	b à
bài	b à i
bàm	b à m
bàn	b à n
bàng	b à ng
bành	b à nh
bào	b à o
bàu	b à u
bày	b à y
bá	b á
bác	b á c
bách	b á ch
bái	b á i
bám	b á m
bán	b á n
báng	b á ng
bánh	b á nh
báo	b á o
báp	b á p
bát	b á t
báu	b á u
báy	b á y
bân	b â n
bâng	b â ng
bâu	b â u
bây	b â y
bã	b ã
bãi	b ã i
bão	b ã o
bè	b è
bèm	b è m
bèn	b è n
bèo	b è o
bé	b é
béc	b é c
béchamel	b é ch a m e l
bén	b é n
bénarès	b é n a r è s
béng	b é ng
béo	b é o
bép	b é p
bét	b é t
bê	b ê
bê tông	b ê t ô ng
bên	b ê n
bênh	b ê nh
bêta	b ê t a
bêu	b ê u
bì	b ì
bìa	b ì a
bìm	b ì m
bình	b ì nh
bìu	b ì u
bí	b í
bích	b í ch
bích quy	b í ch q uy
bím	b í m
bín	b í n
bính	b í nh
bíp	b í p
bít	b í t
bíu	b í u
bò	b ò
bòi	b ò i
bòm	b ò m
bòn	b ò n
bòng	b ò ng
bó	b ó
bóc	b ó c
bói	b ó i
bón	b ó n
bóng	b ó ng
bóp	b ó p
bót	b ó t
bô	b ô
bô đê	b ô đ ê
bôbin	b ô b i n
bôi	b ô i
bôm	b ô m
bôn	b ô n
bông	b ô ng
bônsêvich	b ô n s ê v i ch
bõ	b õ
bõm	b õ m
bõng	b õ ng
bù	b ù
bùa	b ù a
bùi	b ù i
bùm	b ù m
bùn	b ù n
bùng	b ù ng
bú	b ú
búa	b ú a
búi	b ú i
bún	b ú n
búng	b ú ng
búp	b ú p
búp phê	b ú p ph ê
bút	b ú t
băm	b ă m
băn	b ă n
băng	b ă ng
băngca	b ă ng c a
bĩ	b ĩ
bĩnh	b ĩ nh
bĩu	b ĩ u
bũm	b ũ m
bơ	b ơ
bơi	b ơ i
bơm	b ơ m
bơn	b ơ n
bư	b ư
bưa	b ư a
bưng	b ư ng
bưu	b ư u
bươi	b ươ i
bươm	b ươ m
bươn	b ươ n
bương	b ươ ng
bươu	b ươ u
bước	b ướ c
bưới	b ướ i
bướm	b ướ m
bướng	b ướ ng
bướu	b ướ u
bưởi	b ưở i
bượt	b ượ t
bạ	b ạ
bạc	b ạ c
bạch	b ạ ch
bại	b ạ i
bạm	b ạ m
bạn	b ạ n
bạng	b ạ ng
bạnh	b ạ nh
bạo	b ạ o
bạp	b ạ p
bạt	b ạ t
bạu	b ạ u
bả	b ả
bải	b ả i
bản	b ả n
bảng	b ả ng
bảnh	b ả nh
bảo	b ả o
bảu	b ả u
bảy	b ả y
bấc	b ấ c
bấm	b ấ m
bấn	b ấ n
bấng	b ấ ng
bấp	b ấ p
bất	b ấ t
bấu	b ấ u
bấy	b ấ y
bầm	b ầ m
bần	b ầ n
bầng	b ầ ng
bầu	b ầ u
bầy	b ầ y
bẩm	b ẩ m
bẩn	b ẩ n
bẩu	b ẩ u
bẩy	b ẩ y
bẫm	b ẫ m
bẫy	b ẫ y
bậc	b ậ c
bậm	b ậ m
bận	b ậ n
bậng	b ậ ng
bập	b ậ p
bật	b ậ t
bậu	b ậ u
bậy	b ậ y
bắc	b ắ c
bắn	b ắ n
bắng	b ắ ng
bắp	b ắ p
bắt	b ắ t
bằm	b ằ m
bằn	b ằ n
bằng	b ằ ng
bẳm	b ẳ m
bẳn	b ẳ n
bẵm	b ẵ m
bẵng	b ẵ ng
bặc	b ặ c
bặm	b ặ m
bặn	b ặ n
bặng	b ặ ng
bặp	b ặ p
bặt	b ặ t
bẹ	b ẹ
bẹn	b ẹ n
bẹo	b ẹ o
bẹp	b ẹ p
bẹt	b ẹ t
bẻ	b ẻ
bẻm	b ẻ m
bẻo	b ẻ o
bẽ	b ẽ
bẽn	b ẽ n
bẽo	b ẽ o
bế	b ế
bến	b ế n
bếnh	b ế nh
bếp	b ế p
bết	b ế t
bề	b ề
bền	b ề n
bềnh	b ề nh
bều	b ề u
bể	b ể
bển	b ể n
bễ	b ễ
bệ	b ệ
bệch	b ệ ch
bện	b ệ n
bệnh	b ệ nh
bệp	b ệ p
bệt	b ệ t
bệu	b ệ u
bỉ	b ỉ
bỉm	b ỉ m
bỉnh	b ỉ nh
bỉu	b ỉ u
bị	b ị
bịa	b ị a
bịch	b ị ch
bịn	b ị n
bịnh	b ị nh
bịp	b ị p
bịt	b ị t
bịu	b ị u
bọ	b ọ
bọc	b ọ c
bọn	b ọ n
bọng	b ọ ng
bọp	b ọ p
bọt	b ọ t
bỏ	b ỏ
bỏi	b ỏ i
bỏm	b ỏ m
bỏn	b ỏ n
bỏng	b ỏ ng
bố	b ố
bốc	b ố c
bối	b ố i
bốn	b ố n
bống	b ố ng
bốp	b ố p
bốt	b ố t
bồ	b ồ
bồi	b ồ i
bồm	b ồ m
bồn	b ồ n
bồng	b ồ ng
bổ	b ổ
bổi	b ổ i
bổn	b ổ n
bổng	b ổ ng
bỗ	b ỗ
bỗm	b ỗ m
bỗng	b ỗ ng
bộ	b ộ
bộc	b ộ c
bội	b ộ i
bộn	b ộ n
bộng	b ộ ng
bộp	b ộ p
bột	b ộ t
bớ	b ớ
bới	b ớ i
bớn	b ớ n
bớp	b ớ p
bớt	b ớ t
bờ	b ờ
bời	b ờ i
bờm	b ờ m
bờn	b ờ n
bở	b ở
bởi	b ở i
bỡ	b ỡ
bỡn	b ỡ n
bợ	b ợ
bợm	b ợ m
bợn	b ợ n
bợp	b ợ p
bợt	b ợ t
bụ	b ụ
bụa	b ụ a
bục	b ụ c
bụi	b ụ i
bụm	b ụ m
bụng	b ụ ng
bụp	b ụ p
bụt	b ụ t
bủ	b ủ
bủa	b ủ a
bủm	b ủ m
bủn	b ủ n
bủng	b ủ ng
bứ	b ứ
bứa	b ứ a
bức	b ứ c
bứng	b ứ ng
bứt	b ứ t
bừ	b ừ
bừa	b ừ a
bừng	b ừ ng
bử	b ử
bửa	b ử a
bửng	b ử ng
bửu	b ử u
bữa	b ữ a
bự	b ự
bựa	b ự a
bực	b ự c
bựng	b ự ng
bựt	b ự t
ca	c a
cacbon	c a c b o n
cacbonat	c a c b o n a t
cacbonic	c a c b o n i c
cacbua	c a c b u a
cacten	c a c t e n
cactông	c a c t ô ng
cafein	c a f e i n
cai	c a i
calib	c a l i b
cam	c a m
camnhông	c a m nh ô ng
can	c a n
cang	c a ng
canh	c a nh
canke	c a n k e
canxi	c a n x i
canông	c a n ô ng
cao	c a o
caolanh	c a o l a nh
caosu	c a o s u
carate	c a r a t e
carbonat	c a r b o n a t
carbur	c a r b u r
carco	c a r c o
careses	c a r e s e s
cari	c a r i
casse	c a s s e
cation	c a t i o n
catket	c a t k e t
catxet	c a t x e t
catôt	c a t ô t
cau	c a u
cavat	c a v a t
cay	c a y
ce	c e
cedi	c e d i
cen	c e n
centi	c e n t i
cette	c e t t e
ch	ch
cha	ch a
chai	ch a i
cham	ch a m
chambre	ch a m b r e
chan	ch a n
chang	ch a ng
chanh	ch a nh
chantes	ch a n t e s
chao	ch a o
chargés	ch a r g é s
chau	ch a u
chay	ch a y
chdc	ch d c
che	ch e
chem	ch e m
chen	ch e n
cheng	ch e ng
cheo	ch e o
chevaux	ch e v a u x
chi	ch i
chia	ch i a
chiappe	ch i a p p e
chil	ch i l
chim	ch i m
chin	ch i n
chinh	ch i nh
chiu	ch i u
chiêm	ch iê m
chiên	ch iê n
chiêng	ch iê ng
chiêu	ch iê u
chiếc	ch iế c
chiếm	ch iế m
chiến	ch iế n
chiếng	ch iế ng
chiếp	ch iế p
chiết	ch iế t
chiếu	ch iế u
chiền	ch iề n
chiềng	ch iề ng
chiều	ch iề u
chiểu	ch iể u
chiệc	ch iệ c
chiện	ch iệ n
chlor	ch l o r
chlorat	ch l o r a t
chlorhydric	ch l o r h y d r i c
chlorure	ch l o r u r e
cho	ch o
choa	ch oa
choah	ch oa h
choai	ch oa i
choang	ch oa ng
choe	ch oe
choen	ch oe n
choi	ch o i
choisy	ch o i s y
chom	ch o m
chon	ch o n
chong	ch o ng
choài	ch oà i
choàm	ch oà m
choàng	ch oà ng
choành	ch oà nh
choá	ch oá
choác	ch oá c
choái	ch oá i
choán	ch oá n
choáng	ch oá ng
choãi	ch oã i
choè	ch oè
choèn	ch oè n
choé	ch oé
choét	ch oé t
choòng	ch oò ng
choăn	ch oă n
choạc	ch oạ c
choạch	ch oạ ch
choại	ch oạ i
choạng	ch oạ ng
choạp	ch oạ p
choảng	ch oả ng
choắt	ch oắ t
choẹ	ch oẹ
choẹt	ch oẹ t
chu	ch u
chua	ch u a
chui	ch u i
chum	ch u m
chun	ch u n
chung	ch u ng
chuyên	ch uyê n
chuyến	ch uyế n
chuyền	ch uyề n
chuyển	ch uyể n
chuyện	ch uyệ n
chuôi	ch uô i
chuôm	ch uô m
chuông	ch uô ng
chuẩn	ch uẩ n
chuế	ch uế
chuếch	ch uế ch
chuếnh	ch uế nh
chuểnh	ch uể nh
chuệch	ch uệ ch
chuệnh	ch uệ nh
chuốc	ch uố c
chuối	ch uố i
chuốt	ch uố t
chuồi	ch uồ i
chuồn	ch uồ n
chuồng	ch uồ ng
chuổi	ch uổ i
chuỗi	ch uỗ i
chuộc	ch uộ c
chuội	ch uộ i
chuộng	ch uộ ng
chuột	ch uộ t
chuỳ	ch uỳ
chxhcn	ch x h c n
chà	ch à
chài	ch à i
chàm	ch à m
chàng	ch à ng
chành	ch à nh
chào	ch à o
chàu	ch à u
chày	ch à y
chá	ch á
chác	ch á c
chách	ch á ch
chái	ch á i
chán	ch á n
cháng	ch á ng
chánh	ch á nh
cháo	ch á o
cháp	ch á p
chát	ch á t
cháu	ch á u
cháy	ch á y
châm	ch â m
chân	ch â n
châng	ch â ng
châu	ch â u
chây	ch â y
chã	ch ã
chãi	ch ã i
chão	ch ã o
chè	ch è
chèm	ch è m
chèn	ch è n
chèo	ch è o
ché	ch é
chém	ch é m
chén	ch é n
chéng	ch é ng
chéo	ch é o
chép	ch é p
chérie	ch é r i e
chét	ch é t
chê	ch ê
chêm	ch ê m
chênh	ch ê nh
chêu	ch ê u
chì	ch ì
chìa	ch ì a
chìm	ch ì m
chình	ch ì nh
chìu	ch ì u
chí	ch í
chía	ch í a
chích	ch í ch
chím	ch í m
chín	ch í n
chính	ch í nh
chíp	ch í p
chít	ch í t
chíu	ch í u
chò	ch ò
chòe	ch ò e
chòi	ch ò i
chòm	ch ò m
chòng	ch ò ng
chó	ch ó
chóc	ch ó c
chóe	ch ó e
chói	ch ó i
chóng	ch ó ng
chóp	ch ó p
chót	ch ó t
chô	ch ô
chôm	ch ô m
chôn	ch ô n
chông	ch ô ng
chõ	ch õ
chõm	ch õ m
chõng	ch õ ng
chù	ch ù
chùa	ch ù a
chùi	ch ù i
chùm	ch ù m
chùn	ch ù n
chùng	ch ù ng
chùy	ch ù y
chú	ch ú
chúa	ch ú a
chúc	ch ú c
chúi	ch ú i
chúm	ch ú m
chúng	ch ú ng
chút	ch ú t
chăm	ch ă m
chăn	ch ă n
chăng	ch ă ng
chăng2	ch ă ng
chĩ	ch ĩ
chĩa	ch ĩ a
chĩn	ch ĩ n
chĩnh	ch ĩ nh
chĩu	ch ĩ u
chũa	ch ũ a
chũi	ch ũ i
chũm	ch ũ m
chũn	ch ũ n
chũng	ch ũ ng
chơ	ch ơ
chơi	ch ơ i
chơiphúc	ch ơ i ph ú c
chơm	ch ơ m
chơn	ch ơ n
chư	ch ư
chưa	ch ư a
chưn	ch ư n
chưng	ch ư ng
chưong	ch ư o ng
chương	ch ươ ng
chước	ch ướ c
chướng	ch ướ ng
chườm	ch ườ m
chường	ch ườ ng
chưởng	ch ưở ng
chưỡng	ch ưỡ ng
chược	ch ượ c
chượp	ch ượ p
chạ	ch ạ
chạc	ch ạ c
chạch	ch ạ ch
chạm	ch ạ m
chạn	ch ạ n
chạng	ch ạ ng
chạnh	ch ạ nh
chạo	ch ạ o
chạp	ch ạ p
chạt	ch ạ t
chạy	ch ạ y
chả	ch ả
chải	ch ả i
chảm	ch ả m
chảng	ch ả ng
chảnh	ch ả nh
chảo	ch ả o
chảu	ch ả u
chảy	ch ả y
chấm	ch ấ m
chấn	ch ấ n
chấp	ch ấ p
chất	ch ấ t
chấu	ch ấ u
chấy	ch ấ y
chầm	ch ầ m
chần	ch ầ n
chầu	ch ầ u
chầy	ch ầ y
chẩm	ch ẩ m
chẩn	ch ẩ n
chẩu	ch ẩ u
chẩy	ch ẩ y
chẫm	ch ẫ m
chẫn	ch ẫ n
chẫu	ch ẫ u
chậc	ch ậ c
chậm	ch ậ m
chận	ch ậ n
chập	ch ậ p
chật	ch ậ t
chậu	ch ậ u
chậy	ch ậ y
chắc	ch ắ c
chắm	ch ắ m
chắn	ch ắ n
chắp	ch ắ p
chắt	ch ắ t
chằm	ch ằ m
chằn	ch ằ n
chằng	ch ằ ng
chẳng	ch ẳ ng
chẵn	ch ẵ n
chặc	ch ặ c
chặm	ch ặ m
chặn	ch ặ n
chặng	ch ặ ng
chặp	ch ặ p
chặt	ch ặ t
chẹn	ch ẹ n
chẹo	ch ẹ o
chẹp	ch ẹ p
chẹt	ch ẹ t
chẻ	ch ẻ
chẻm	ch ẻ m
chẻn	ch ẻ n
chẻng	ch ẻ ng
chẻo	ch ẻ o
chẽ	ch ẽ
chẽm	ch ẽ m
chẽn	ch ẽ n
chế	ch ế
chếch	ch ế ch
chếnh	ch ế nh
chếp	ch ế p
chết	ch ế t
chề	ch ề
chềm	ch ề m
chềnh	ch ề nh
chểnh	ch ể nh
chễm	ch ễ m
chễnh	ch ễ nh
chệ	ch ệ
chệch	ch ệ ch
chệm	ch ệ m
chện	ch ệ n
chệnh	ch ệ nh
chệp	ch ệ p
chệt	ch ệ t
chỉ	ch ỉ
chỉa	ch ỉ a
chỉn	ch ỉ n
chỉnh	ch ỉ nh
chị	ch ị
chịa	ch ị a
chịn	ch ị n
chịt	ch ị t
chịu	ch ị u
chọ	ch ọ
chọc	ch ọ c
chọe	ch ọ e
chọi	ch ọ i
chọn	ch ọ n
chọp	ch ọ p
chọt	ch ọ t
chỏ	ch ỏ
chỏi	ch ỏ i
chỏm	ch ỏ m
chỏn	ch ỏ n
chỏng	ch ỏ ng
chốc	ch ố c
chối	ch ố i
chốn	ch ố n
chống	ch ố ng
chốp	ch ố p
chốt	ch ố t
chồ	ch ồ
chồi	ch ồ i
chồm	ch ồ m
chồn	ch ồ n
chồng	ch ồ ng
chổ	ch ổ
chổi	ch ổ i
chổm	ch ổ m
chổng	ch ổ ng
chỗ	ch ỗ
chỗi	ch ỗ i
chỗm	ch ỗ m
chộ	ch ộ
chội	ch ộ i
chộn	ch ộ n
chộp	ch ộ p
chột	ch ộ t
chớ	ch ớ
chới	ch ớ i
chớm	ch ớ m
chớn	ch ớ n
chớp	ch ớ p
chớt	ch ớ t
chờ	ch ờ
chờm	ch ờ m
chờn	ch ờ n
chở	ch ở
chởm	ch ở m
chợ	ch ợ
chợn	ch ợ n
chợp	ch ợ p
chợt	ch ợ t
chụa	ch ụ a
chục	ch ụ c
chụm	ch ụ m
chụp	ch ụ p
chụt	ch ụ t
chủ	ch ủ
chủa	ch ủ a
chủm	ch ủ m
chủn	ch ủ n
chủng	ch ủ ng
chứ	ch ứ
chứa	ch ứ a
chức	ch ứ c
chứng	ch ứ ng
chứt	ch ứ t
chừ	ch ừ
chừa	ch ừ a
chừng	ch ừ ng
chử	ch ử
chửa	ch ử a
chửi	ch ử i
chửng	ch ử ng
chữ	ch ữ
chữa	ch ữ a
chững	ch ữ ng
chực	ch ự c
chựng	ch ự ng
cif	c i f
cl	c l
cla	c l a
clanh	c l a nh
clb	c l b
cli	c l i
clin	c l i n
clinke	c l i n k e
clinker	c l i n k e r
clo	c l o
clohiđric	c l o h i đ r i c
clorat	c l o r a t
clorua	c l o r u a
cléopâtre	c l é o p â tr e
cm	c m
cn	c n
cntb	c n t b
cnxh	c n x h
co	c o
coc	c o c
coction	c o c t i o n
cocus	c o c u s
codeine	c o d e i n e
coi	c o i
col	c o l
cologa	c o l o g a
cologarit	c o l o g a r i t
colophon	c o l o ph o n
com	c o m
comme	c o m m e
commăng	c o m m ă ng
compa	c o m p a
con	c o n
conduil	c o n d u i l
cong	c o ng
connecto	c o n n e c t o
constate	c o n s t a t e
contax	c o n t a x
contrabass	c o n tr a b a s s
contre	c o n tr e
conxo acxiom	c o n x o a c x i o m
coong	c oo ng
copfa	c o p f a
cortison	c o r t i s o n
cosin	c o s i n
cot	c o t
cotang	c o t a ng
coulomb	c o u l o m b
courbet	c o u r b e t
coóc	c oó c
coọc	c oọ c
cpu	c p u
cr	c r
cra	c r a
crin	c r i n
croute	c r o u t e
cru	c r u
créations	c r é a t i o n s
crénom	c r é n o m
crêp	c r ê p
crôm	c r ô m
crông	c r ô ng
crếp	c r ế p
cs	c s
cty	c t y
cu	c u
cua	c u a
cui	c u i
culi	c u l i
culit	c u l i t
culon	c u l o n
culong	c u l o ng
culông	c u l ô ng
cum	c u m
cun	c u n
cung	c u ng
curoa	c u r oa
cuông	c uô ng
cuôr	c uô r
cuốc	c uố c
cuối	c uố i
cuốn	c uố n
cuống	c uố ng
cuồn	c uồ n
cuồng	c uồ ng
cuỗm	c uỗ m
cuộc	c uộ c
cuội	c uộ i
cuộn	c uộ n
cuộng	c uộ ng
cy	c y
cybernetic	c y b e r n e t i c
cà	c à
cài	c à i
càm	c à m
càn	c à n
càng	c à ng
cành	c à nh
cào	c à o
càu	c à u
cày	c à y
cá	c á
các	c á c
cách	c á ch
cái	c á i
cáiân	c á i â n
cám	c á m
cán	c á n
cáng	c á ng
cánh	c á nh
cáo	c á o
cáp	c á p
cát	c á t
cáu	c á u
cáy	c á y
câm	c â m
cân	c â n
câng	c â ng
câu	c â u
cây	c â y
cãi	c ã i
cò	c ò
còi	c ò i
còm	c ò m
còn	c ò n
còng	c ò ng
có	c ó
cóc	c ó c
cói	c ó i
cóm	c ó m
cón	c ó n
cóng	c ó ng
cóoc	c ó o c
cóp	c ó p
cót	c ó t
cô	c ô
côi	c ô i
côm	c ô m
côn	c ô n
công	c ô ng
công tắc	c ô ng t ắ c
côngxon	c ô ng x o n
côsin	c ô s i n
côtang	c ô t a ng
côtông	c ô t ô ng
côve	c ô v e
côống	c ô ố ng
cõi	c õ i
cõm	c õ m
cõng	c õ ng
cù	c ù
cùa	c ù a
cùi	c ù i
cùm	c ù m
cùn	c ù n
cùng	c ù ng
cú	c ú
cúa	c ú a
cúc	c ú c
cúi	c ú i
cúm	c ú m
cún	c ú n
cúng	c ú ng
cúp	c ú p
cút	c ú t
căm	c ă m
căn	c ă n
căng	c ă ng
căngtin	c ă ng t i n
cũ	c ũ
cũi	c ũ i
cũn	c ũ n
cũng	c ũ ng
cơ	c ơ
cơi	c ơ i
cơm	c ơ m
cơn	c ơ n
cư	c ư
cưa	c ư a
cưng	c ư ng
cưu	c ư u
cương	c ươ ng
cước	c ướ c
cưới	c ướ i
cướp	c ướ p
cười	c ườ i
cườm	c ườ m
cường	c ườ ng
cưỡi	c ưỡ i
cưỡng	c ưỡ ng
cược	c ượ c
cạ	c ạ
cạc	c ạ c
cạch	c ạ ch
cạm	c ạ m
cạn	c ạ n
cạnh	c ạ nh
cạo	c ạ o
cạp	c ạ p
cạu	c ạ u
cạy	c ạ y
cả	c ả
cải	c ả i
cảm	c ả m
cản	c ả n
cảng	c ả ng
cảnh	c ả nh
cảo	c ả o
cảu	c ả u
cảy	c ả y
cấc	c ấ c
cấm	c ấ m
cấn	c ấ n
cấp	c ấ p
cất	c ấ t
cấu	c ấ u
cấy	c ấ y
cầm	c ầ m
cần	c ầ n
cầu	c ầ u
cầy	c ầ y
cẩm	c ẩ m
cẩn	c ẩ n
cẩu	c ẩ u
cẩy	c ẩ y
cẫm	c ẫ m
cẫn	c ẫ n
cẫng	c ẫ ng
cậm	c ậ m
cận	c ậ n
cập	c ậ p
cật	c ậ t
cậu	c ậ u
cậy	c ậ y
cắc	c ắ c
cắm	c ắ m
cắn	c ắ n
cắng	c ắ ng
cắp	c ắ p
cắt	c ắ t
cằm	c ằ m
cằn	c ằ n
cẳn	c ẳ n
cẳng	c ẳ ng
cẵng	c ẵ ng
cặc	c ặ c
cặm	c ặ m
cặn	c ặ n
cặp	c ặ p
cặt	c ặ t
cọ	c ọ
cọc	c ọ c
cọi	c ọ i
cọm	c ọ m
cọn	c ọ n
cọng	c ọ ng
cọp	c ọ p
cọt	c ọ t
cỏ	c ỏ
cỏi	c ỏ i
cỏm	c ỏ m
cỏn	c ỏ n
cố	c ố
cốc	c ố c
cối	c ố i
cốm	c ố m
cốn	c ố n
cống	c ố ng
cốp	c ố p
cốt	c ố t
cồ	c ồ
cồm	c ồ m
cồn	c ồ n
cồng	c ồ ng
cổ	c ổ
cổi	c ổ i
cổn	c ổ n
cổng	c ổ ng
cỗ	c ỗ
cỗi	c ỗ i
cộ	c ộ
cộc	c ộ c
cội	c ộ i
cộm	c ộ m
cộn	c ộ n
cộng	c ộ ng
cộp	c ộ p
cột	c ộ t
cớ	c ớ
cớm	c ớ m
cớn	c ớ n
cớt	c ớ t
cờ	c ờ
cời	c ờ i
cờn	c ờ n
cởi	c ở i
cỡ	c ỡ
cỡi	c ỡ i
cỡm	c ỡ m
cỡn	c ỡ n
cợm	c ợ m
cợn	c ợ n
cợp	c ợ p
cợt	c ợ t
cụ	c ụ
cục	c ụ c
cụi	c ụ i
cụm	c ụ m
cụng	c ụ ng
cụp	c ụ p
cụt	c ụ t
củ	c ủ
của	c ủ a
củi	c ủ i
củm	c ủ m
củn	c ủ n
củng	c ủ ng
cứ	c ứ
cứa	c ứ a
cức	c ứ c
cứng	c ứ ng
cứt	c ứ t
cứu	c ứ u
cừ	c ừ
cừu	c ừ u
cử	c ử
cửa	c ử a
cửi	c ử i
cửng	c ử ng
cửu	c ử u
cữ	c ữ
cữa	c ữ a
cữu	c ữ u
cự	c ự
cựa	c ự a
cực	c ự c
cựu	c ự u
da	d a
dai	d a i
dalasi	d a l a s i
dam	d a m
dan	d a n
dang	d a ng
danh	d a nh
dans	d a n s
dao	d a o
daudet	d a u d e t
day	d a y
de	d e
deauville	d e a u v i l l e
deca	d e c a
deci	d e c i
delagare	d e l a g a r e
demivierges	d e m i v i e r g e s
demurir	d e m u r i r
demurrer	d e m u r r e r
den	d e n
denar	d e n a r
deo	d e o
dernières	d e r n i è r e s
descaves	d e s c a v e s
devenue	d e v e n u e
dgieh	d gi e h
dhonneur	d h o n n e u r
di	d i
dicdăc	d i c d ă c
dieuz	d i e u z
dim	d i m
din	d i n
dinh	d i nh
diogène	d i o g è n e
diopter	d i o p t e r
directeur	d i r e c t e u r
dirham	d i r h a m
dite	d i t e
diu	d i u
diêm	d iê m
diên	d iê n
diêu	d iê u
diếc	d iế c
diếm	d iế m
diếp	d iế p
diết	d iế t
diếu	d iế u
diềm	d iề m
diềng	d iề ng
diều	d iề u
diễm	d iễ m
diễn	d iễ n
diễu	d iễ u
diệc	d iệ c
diệm	d iệ m
diện	d iệ n
diệp	d iệ p
diệt	d iệ t
diệu	d iệ u
do	d o
doa	d oa
doan	d oa n
doanh	d oa nh
dobra	d o b r a
docphin	d o c ph i n
doi	d o i
dom	d o m
don	d o n
dong	d o ng
doping	d o p i ng
dostoievsky	d o s t o i e v s k y
doumer	d o u m e r
doàng	d oà ng
doành	d oà nh
doá	d oá
doãi	d oã i
doãn	d oã n
doãng	d oã ng
doạ	d oạ
doạng	d oạ ng
drăm	d r ă m
drăng	d r ă ng
dt	d t
du	d u
dua	d u a
duhaniel	d u h a n i e l
dumdum	d u m d u m
dun	d u n
dung	d u ng
duralumin	d u r a l u m i n
duy	d uy
duyên	d uyê n
duyệt	d uyệ t
duôi	d uô i
duật	d uậ t
duềnh	d uề nh
duệ	d uệ
duốc	d uố c
duối	d uố i
duồn	d uồ n
duỗi	d uỗ i
duộc	d uộ c
dy	d y
dyn	d y n
dynamit	d y n a m i t
dà	d à
dài	d à i
dàm	d à m
dàn	d à n
dàng	d à ng
dành	d à nh
dào	d à o
dàu	d à u
dày	d à y
dá	d á
dác	d á c
dách	d á ch
dái	d á i
dám	d á m
dán	d á n
dáng	d á ng
dáo	d á o
dát	d á t
dáu	d á u
dáy	d á y
dâm	d â m
dân	d â n
dâng	d â ng
dâu	d â u
dây	d â y
dã	d ã
dãi	d ã i
dãn	d ã n
dãng	d ã ng
dãy	d ã y
dè	d è
dèm	d è m
dèn	d è n
dé	d é
déclare	d é c l a r e
dém	d é m
démon	d é m o n
déo	d é o
dép	d é p
dét	d é t
dê	d ê
dên	d ê n
dênh	d ê nh
dì	d ì
dìa	d ì a
dìm	d ì m
dình	d ì nh
dìu	d ì u
dí	d í
dích	d í ch
dím	d í m
dính	d í nh
díp	d í p
dít	d í t
díu	d í u
dò	d ò
dòi	d ò i
dòm	d ò m
dòn	d ò n
dòng	d ò ng
dó	d ó
dóa	d óa
dóc	d ó c
dói	d ó i
dóm	d ó m
dón	d ó n
dóng	d ó ng
dót	d ó t
dô	d ô
dôi	d ô i
dôn	d ô n
dông	d ô ng
dõi	d õ i
dõng	d õ ng
dù	d ù
dùa	d ù a
dùi	d ù i
dùm	d ù m
dùn	d ù n
dùng	d ù ng
dúa	d ú a
dúi	d ú i
dúm	d ú m
dún	d ú n
dúng	d ú ng
dút	d ú t
dýn	d ý n
dăm	d ă m
dăn	d ă n
dăng	d ă ng
dĩ	d ĩ
dĩa	d ĩ a
dĩn	d ĩ n
dĩnh	d ĩ nh
dũ	d ũ
dũa	d ũ a
dũi	d ũ i
dũng	d ũ ng
dơ	d ơ
dơ nê	d ơ n ê
dơi	d ơ i
dơm	d ơ m
dơn	d ơ n
dư	d ư
dưa	d ư a
dưng	d ư ng
dương	d ươ ng
dưới	d ướ i
dướn	d ướ n
dướng	d ướ ng
dường	d ườ ng
dưỡng	d ưỡ ng
dược	d ượ c
dượi	d ượ i
dượng	d ượ ng
dượt	d ượ t
dạ	d ạ
dạc	d ạ c
dại	d ạ i
dại3	d ạ i
dạm	d ạ m
dạn	d ạ n
dạng	d ạ ng
dạo	d ạ o
dạt	d ạ t
dạy	d ạ y
dả	d ả
dải	d ả i
dảnh	d ả nh
dảy	d ả y
dấm	d ấ m
dấn	d ấ n
dấp	d ấ p
dấu	d ấ u
dấy	d ấ y
dầm	d ầ m
dần	d ầ n
dầu	d ầ u
dầy	d ầ y
dẩm	d ẩ m
dẩn	d ẩ n
dẩu	d ẩ u
dẩy	d ẩ y
dẫm	d ẫ m
dẫn	d ẫ n
dẫu	d ẫ u
dẫy	d ẫ y
dậm	d ậ m
dận	d ậ n
dập	d ậ p
dật	d ậ t
dậu	d ậ u
dậy	d ậ y
dắc	d ắ c
dắm	d ắ m
dắng	d ắ ng
dắt	d ắ t
dằm	d ằ m
dằn	d ằ n
dằng	d ằ ng
dẳn	d ẳ n
dẳng	d ẳ ng
dặc	d ặ c
dặm	d ặ m
dặn	d ặ n
dặt	d ặ t
dẹm	d ẹ m
dẹo	d ẹ o
dẹp	d ẹ p
dẹt	d ẹ t
dẻ	d ẻ
dẻo	d ẻ o
dẽ	d ẽ
dế	d ế
dếch	d ế ch
dết	d ế t
dề	d ề
dền	d ề n
dềnh	d ề nh
dể	d ể
dễ	d ễ
dệ	d ệ
dệch	d ệ ch
dện	d ệ n
dệnh	d ệ nh
dệt	d ệ t
dệu	d ệ u
dỉ	d ỉ
dị	d ị
dịch	d ị ch
dịn	d ị n
dịp	d ị p
dịt	d ị t
dịu	d ị u
dọ	d ọ
dọa	d ọa
dọc	d ọ c
dọi	d ọ i
dọn	d ọ n
dọng	d ọ ng
dọp	d ọ p
dỏ	d ỏ
dỏi	d ỏ i
dỏm	d ỏ m
dỏng	d ỏ ng
dốc	d ố c
dối	d ố i
dống	d ố ng
dốp	d ố p
dốt	d ố t
dồ	d ồ
dồi	d ồ i
dồn	d ồ n
dồng	d ồ ng
dổi	d ổ i
dổm	d ổ m
dỗ	d ỗ
dỗi	d ỗ i
dộc	d ộ c
dội	d ộ i
dộng	d ộ ng
dộp	d ộ p
dột	d ộ t
dớ	d ớ
dới	d ớ i
dớm	d ớ m
dớn	d ớ n
dớp	d ớ p
dờ	d ờ
dời	d ờ i
dờn	d ờ n
dở	d ở
dởm	d ở m
dỡ	d ỡ
dợ	d ợ
dợm	d ợ m
dợn	d ợ n
dụ	d ụ
dụa	d ụ a
dục	d ụ c
dụi	d ụ i
dụm	d ụ m
dụng	d ụ ng
dụt	d ụ t
dủ	d ủ
dủi	d ủ i
dứ	d ứ
dứa	d ứ a
dức	d ứ c
dứng	d ứ ng
dứt	d ứ t
dừ	d ừ
dừa	d ừ a
dừng	d ừ ng
dử	d ử
dửng	d ử ng
dữ	d ữ
dự	d ự
dựa	d ự a
dực	d ự c
dựng	d ự ng
dựt	d ự t
e	e
ebonit	e b o n i t
elip	e l i p
em	e m
emetin	e m e t i n
empéche	e m p é ch e
en	e n
enabuse	e n a b u s e
enchantée	e n ch a n t é e
enfin	e n f i n
eng	e ng
entrainer	e n tr a i n e r
entrez	e n tr e z
entropi	e n tr o p i
enzim	e n z i m
eo	e o
essayer	e s s a y e r
et	e t
eta	e t a
ete	e t e
eto	e t o
etxăng	e t x ă ng
etylen	e t y l e n
eur	e u r
européens	e u r o p é e n s
evremond	e v r e m o n d
excès	e x c è s
exercer	e x e r c e r
explica	e x p l i c a
extrême	e x tr ê m e
fa	f a
fara	f a r a
fatxit	f a t x i t
feldspat	f e l d sp a t
femmes	f e m m e s
fenspat	f e n sp a t
ferions	f e r i o n s
ferit	f e r i t
fff	f f f
fibroximăng	f i b r o x i m ă ng
fie	f i e
filleaperdusa	f i l l e a p e r d u s a
finit	f i n i t
finot	f i n o t
florua	f l o r u a
fluorur	f l u o r u r
fo	f o
fol	f o l
folies	f o l i e s
folklor	f o l k l o r
fomanđehit	f o m a n đ e h i t
fomol	f o m o l
fon	f o n
formaldehyd	f o r m a l d e h y d
formol	f o r m o l
fou	f o u
foudre	f o u d r e
foutez	f o u t e z
foxep	f o x e p
foóc	f oó c
frăng	f r ă ng
fut	f u t
fuy	f uy
fuốc	f uố c
fát	f á t
féc	f é c
ga	g a
gabađin	g a b a đ i n
gaconnière	g a c o n n i è r e
gacđiêng	g a c đ iê ng
gai	g a i
gaiam	g a i a m
galăng	g a l ă ng
gam	g a m
gamen	g a m e n
gan	g a n
gang	g a ng
ganh	g a nh
gao	g a o
gar	g a r
garconière	g a r c o n i è r e
garconnière	g a r c o n n i è r e
gau	g a u
gay	g a y
gdp	g d p
ge	g e
gen	g e n
germanium	g e r m a n i u m
ghe	gh e
ghen	gh e n
ghi	gh i
ghim	gh i m
ghin	gh i n
ghita	gh i t a
ghiếc	gh iế c
ghiến	gh iế n
ghiền	gh iề n
ghè	gh è
ghèn	gh è n
ghé	gh é
ghém	gh é m
ghép	gh é p
ghét	gh é t
ghê	gh ê
ghì	gh ì
ghìm	gh ì m
ghình	gh ì nh
ghín	gh í n
ghính	gh í nh
ghít	gh í t
ghĩ	gh ĩ
ghẹ	gh ẹ
ghẹo	gh ẹ o
ghẻ	gh ẻ
ghẽ	gh ẽ
ghế	gh ế
ghếch	gh ế ch
ghết	gh ế t
ghề	gh ề
ghềnh	gh ề nh
ghểnh	gh ể nh
ghễnh	gh ễ nh
ghệch	gh ệ ch
ghệt	gh ệ t
gi	gi
gia	gi a
giai	gi a i
giam	gi a m
gian	gi a n
giang	gi a ng
gianh	gi a nh
giao	gi a o
giau	gi a u
gic	gi c
gide	gi d e
gie	gi e
gien	gi e n
gieo	gi e o
gin	gi n
gio	gi o
gioi	gi o i
gion	gi o n
giong	gi o ng
gioong	gi oo ng
gioàng	gi oà ng
gioòng	gi oò ng
gioăng	gi oă ng
gip	gi p
giu	gi u
giua	gi u a
giun	gi u n
giuộc	gi uộ c
già	gi à
giàm	gi à m
giàn	gi à n
giàng	gi à ng
giành	gi à nh
giào	gi à o
giàu	gi à u
giày	gi à y
giá	gi á
giác	gi á c
giám	gi á m
gián	gi á n
giáng	gi á ng
giáo	gi á o
giáp	gi á p
giát	gi á t
giáy	gi á y
giâm	gi â m
giâu	gi â u
giây	gi â y
giã	gi ã
giãi	gi ã i
giãn	gi ã n
giãy	gi ã y
gièm	gi è m
gié	gi é
giéo	gi é o
giê	gi ê
giêng	gi ê ng
giò	gi ò
giòi	gi ò i
giòn	gi ò n
giòng	gi ò ng
gió	gi ó
gióc	gi ó c
giói	gi ó i
gión	gi ó n
gióng	gi ó ng
giô	gi ô
giôn	gi ô n
giông	gi ô ng
giõi	gi õ i
giùi	gi ù i
giùm	gi ù m
giú	gi ú
giúi	gi ú i
giúm	gi ú m
giúp	gi ú p
giăm	gi ă m
giăm bông	gi ă m b ô ng
giăng	gi ă ng
giũ	gi ũ
giũa	gi ũ a
giơ	gi ơ
giơi	gi ơ i
giương	gi ươ ng
giướng	gi ướ ng
giường	gi ườ ng
giạ	gi ạ
giạc	gi ạ c
giại	gi ạ i
giạm	gi ạ m
giạng	gi ạ ng
giạp	gi ạ p
giạt	gi ạ t
giả	gi ả
giải	gi ả i
giảm	gi ả m
giản	gi ả n
giảng	gi ả ng
giảnh	gi ả nh
giảo	gi ả o
giảu	gi ả u
giấc	gi ấ c
giấm	gi ấ m
giấn	gi ấ n
giấp	gi ấ p
giấu	gi ấ u
giấy	gi ấ y
giầm	gi ầ m
giần	gi ầ n
giầu	gi ầ u
giầy	gi ầ y
giẩu	gi ẩ u
giẫm	gi ẫ m
giẫy	gi ẫ y
giậm	gi ậ m
giận	gi ậ n
giập	gi ậ p
giật	gi ậ t
giậu	gi ậ u
giắc	gi ắ c
giắn	gi ắ n
giắng	gi ắ ng
giắt	gi ắ t
giằm	gi ằ m
giằn	gi ằ n
giằng	gi ằ ng
giẳn	gi ẳ n
giẵm	gi ẵ m
giặc	gi ặ c
giặm	gi ặ m
giặn	gi ặ n
giặt	gi ặ t
giẹo	gi ẹ o
giẹp	gi ẹ p
giẻ	gi ẻ
giếc	gi ế c
giếm	gi ế m
giếng	gi ế ng
giết	gi ế t
giề	gi ề
giền	gi ề n
giềng	gi ề ng
giễu	gi ễ u
giọ	gi ọ
giọc	gi ọ c
giọi	gi ọ i
giọng	gi ọ ng
giọt	gi ọ t
giỏ	gi ỏ
giỏi	gi ỏ i
giỏn	gi ỏ n
giốc	gi ố c
giống	gi ố ng
giốt	gi ố t
giồ	gi ồ
giồi	gi ồ i
giồng	gi ồ ng
giổi	gi ổ i
giỗ	gi ỗ
giỗi	gi ỗ i
giộ	gi ộ
giội	gi ộ i
giộp	gi ộ p
giới	gi ớ i
giờ	gi ờ
giời	gi ờ i
giờn	gi ờ n
giở	gi ở
giỡ	gi ỡ
giỡn	gi ỡ n
giụa	gi ụ a
giục	gi ụ c
giụi	gi ụ i
giủi	gi ủ i
giừ	gi ừ
giữ	gi ữ
giữa	gi ữ a
giựt	gi ự t
glacées	g l a c é e s
glai	g l a i
glaucom	g l a u c o m
gli	g l i
glu	g l u
glucid	g l u c i d
gluco	g l u c o
gluxit	g l u x i t
glycerin	g l y c e r i n
glôcôm	g l ô c ô m
glăng	g l ă ng
gmt	g m t
gnp	g n p
go	g o
gom	g o m
gomorrhe	g o m o r r h e
gon	g o n
goong	g oo ng
gourde	g o u r d e
goá	g oá
goòng	g oò ng
gr	g r
gra	g r a
grafferi	g r a f f e r i
granit	g r a n i t
graphit	g r a ph i t
grapomllot	g r a p o m l l o t
gric	g r i c
grát	g r á t
gs	g s
gu	g u
gueule	g u e u l e
guy	g uy
guyane	g uy a n e
guđron	g u đ r o n
guốc	g uố c
guồng	g uồ ng
guổng	g uổ ng
guộc	g uộ c
guộn	g uộ n
guột	g uộ t
gà	g à
gài	g à i
gàn	g à n
gàng	g à ng
gành	g à nh
gào	g à o
gàu	g à u
gày	g à y
gá	g á
gác	g á c
gách	g á ch
gái	g á i
gán	g á n
gánh	g á nh
gáo	g á o
gáp	g á p
gát	g á t
gáu	g á u
gáy	g á y
gâm	g â m
gân	g â n
gâu	g â u
gây	g â y
gã	g ã
gãi	g ã i
gãy	g ã y
gì	g ì
gìa	g ì a
gìm	g ì m
gìn	g ì n
gí	g í
gích	g í ch
gíp	g í p
gò	g ò
gòn	g ò n
góa	g óa
góc	g ó c
gói	g ó i
góp	g ó p
gót	g ó t
gô	g ô
gôm	g ô m
gôn	g ô n
gông	g ô ng
gôrila	g ô r i l a
gõ	g õ
gù	g ù
gùa	g ù a
gùi	g ù i
gùn	g ù n
gùng	g ù ng
gú	g ú
gúa	g ú a
gút	g ú t
găm	g ă m
găn	g ă n
găng	g ă ng
gũi	g ũ i
gơ	g ơ
gơn	g ơ n
gươm	g ươ m
gương	g ươ ng
gườm	g ườ m
gường	g ườ ng
gưỡng	g ưỡ ng
gượm	g ượ m
gượng	g ượ ng
gạ	g ạ
gạc	g ạ c
gạch	g ạ ch
gại	g ạ i
gạn	g ạ n
gạnh	g ạ nh
gạo	g ạ o
gạt	g ạ t
gạy	g ạ y
gả	g ả
gảnh	g ả nh
gảy	g ả y
gấc	g ấ c
gấm	g ấ m
gấp	g ấ p
gấu	g ấ u
gấy	g ấ y
gầm	g ầ m
gần	g ầ n
gầu	g ầ u
gầy	g ầ y
gẩm	g ẩ m
gẩy	g ẩ y
gẫm	g ẫ m
gẫu	g ẫ u
gẫy	g ẫ y
gậm	g ậ m
gận	g ậ n
gập	g ậ p
gật	g ậ t
gậy	g ậ y
gắm	g ắ m
gắn	g ắ n
gắng	g ắ ng
gắp	g ắ p
gắt	g ắ t
gằm	g ằ m
gằn	g ằ n
gẵng	g ẵ ng
gặc	g ặ c
gặm	g ặ m
gặn	g ặ n
gặng	g ặ ng
gặp	g ặ p
gặt	g ặ t
gềnh	g ề nh
gỉ	g ỉ
gỉn	g ỉ n
gịa	g ị a
gọ	g ọ
gọc	g ọ c
gọi	g ọ i
gọn	g ọ n
gọng	g ọ ng
gọt	g ọ t
gỏi	g ỏ i
gỏl	g ỏ l
gỏng	g ỏ ng
gốc	g ố c
gối	g ố i
gốm	g ố m
gồ	g ồ
gồi	g ồ i
gồm	g ồ m
gồng	g ồ ng
gổ	g ổ
gỗ	g ỗ
gộ	g ộ
gộc	g ộ c
gội	g ộ i
gộp	g ộ p
gột	g ộ t
gớm	g ớ m
gờ	g ờ
gờm	g ờ m
gờn	g ờ n
gở	g ở
gởi	g ở i
gỡ	g ỡ
gợi	g ợ i
gợn	g ợ n
gợt	g ợ t
gụ	g ụ
gục	g ụ c
gụi	g ụ i
gụt	g ụ t
gụvv	g ụ v v
gủa	g ủ a
gứng	g ứ ng
gừ	g ừ
gừng	g ừ ng
gửi	g ử i
gỵa	g ỵ a
ha	h a
hai	h a i
haivaienne	h a i v a i e n n e
ham	h a m
han	h a n
hang	h a ng
hanh	h a nh
hanoians	h a n o i a n s
hanoiennes	h a n o i e n n e s
hantise	h a n t i s e
hao	h a o
hau	h a u
hawaienne	h a w a i e n n e
hay	h a y
he	h e
hec	h e c
hecta	h e c t a
hecto	h e c t o
heli	h e l i
hem	h e m
hematit	h e m a t i t
hen	h e n
heo	h e o
herriot	h e r r i o t
heureux	h e u r e u x
hg	h g
hi	h i
hia	h i a
him	h i m
hin	h i n
hinh	h i nh
hiperbol	h i p e r b o l
hippy	h i p p y
hirchleld	h i r ch l e l d
hiu	h i u
hiv	h i v
hiên	h iê n
hiêng	h iê ng
hiđro	h i đ r o
hiđrocacbon	h i đ r o c a c b o n
hiđroclorua	h i đ r o c l o r u a
hiđroxit	h i đ r o x i t
hiếc	h iế c
hiếm	h iế m
hiến	h iế n
hiếng	h iế ng
hiếp	h iế p
hiếu	h iế u
hiềm	h iề m
hiền	h iề n
hiểm	h iể m
hiển	h iể n
hiểu	h iể u
hiện	h iệ n
hiệp	h iệ p
hiệt	h iệ t
hiệu	h iệ u
hlv	h l v
hmu	h m u
hning	h n i ng
ho	h o
hoa	h oa
hoai	h oa i
hoan	h oa n
hoang	h oa ng
hoay	h oa y
hoc	h o c
hocmon	h o c m o n
hoe	h oe
hoen	h oe n
hoi	h o i
hom	h o m
hon	h o n
hong	h o ng
honni	h o n n i
hormon	h o r m o n
houbigant	h o u b i g a n t
hoà	h oà
hoài	h oà i
hoàn	h oà n
hoàng	h oà ng
hoành	h oà nh
hoá	h oá
hoác	h oá c
hoán	h oá n
hoáng	h oá ng
hoánh	h oá nh
hoáy	h oá y
hoãn	h oã n
hoãng	h oã ng
hoè	h oè
hoét	h oé t
hoóc	h oó c
hoăm	h oă m
hoăng	h oă ng
hoạ	h oạ
hoạch	h oạ ch
hoại	h oạ i
hoạn	h oạ n
hoạnh	h oạ nh
hoạt	h oạ t
hoả	h oả
hoải	h oả i
hoảng	h oả ng
hoảnh	h oả nh
hoắc	h oắ c
hoắm	h oắ m
hoắt	h oắ t
hoằn	h oằ n
hoẳn	h oẳ n
hoẵng	h oẵ ng
hoặc	h oặ c
hoặn	h oặ n
hoẹ	h oẹ
hoẹt	h oẹ t
hoẻn	h oẻ n
hreng	h r e ng
hroi	h r o i
hryvnia	h r y v n i a
hrê	h r ê
ht	h t
htx	h t x
hu	h u
hua	h u a
hui	h u i
hum	h u m
humaine	h u m a i n e
humains	h u m a i n s
hun	h u n
hung	h u ng
huy	h uy
huynh	h uy nh
huyên	h uyê n
huyết	h uyế t
huyền	h uyề n
huyễn	h uyễ n
huyện	h uyệ n
huyệt	h uyệ t
huân	h uâ n
huê	h uê
huênh	h uê nh
huý	h uý
huých	h uý ch
huýt	h uý t
huơ	h uơ
huấn	h uấ n
huầy	h uầ y
huế	h uế
huếch	h uế ch
huề	h uề
huệ	h uệ
huống	h uố ng
huốt	h uố t
huỳnh	h uỳ nh
huỵch	h uỵ ch
huỷ	h uỷ
hv	h v
hy	h y
hydrochloride	h y d r o ch l o r i d e
hypebol	h y p e b o l
hz	h z
hà	h à
hài	h à i
hàm	h à m
hàn	h à n
hàng	h à ng
hành	h à nh
hào	h à o
hàu	h à u
há	h á
hác	h á c
hách	h á ch
hái	h á i
hám	h á m
hán	h á n
háng	h á ng
hánh	h á nh
háo	h á o
háp	h á p
hát	h á t
háu	h á u
háy	h á y
hâm	h â m
hân	h â n
hâu	h â u
hây	h â y
hãi	h ã i
hãm	h ã m
hãn	h ã n
hãng	h ã ng
hãnh	h ã nh
hão	h ã o
hãy	h ã y
hè	h è
hèm	h è m
hèn	h è n
hèo	h è o
hé	h é
héc	h é c
hén	h é n
héo	h é o
hét	h é t
hê	h ê
hên	h ê n
hênh	h ê nh
hì	h ì
hìinh	h ì i nh
hình	h ì nh
hí	h í
hích	h í ch
híp	h í p
hít	h í t
hò	h ò
hòa	h òa
hòe	h ò e
hòi	h ò i
hòm	h ò m
hòn	h ò n
hòng	h ò ng
hó	h ó
hóa	h óa
hóc	h ó c
hói	h ó i
hóm	h ó m
hón	h ó n
hóng	h ó ng
hóp	h ó p
hót	h ó t
hô	h ô
hôi	h ô i
hôm	h ô m
hôn	h ô n
hông	h ô ng
hôtel	h ô t e l
hõm	h õ m
hù	h ù
hùa	h ù a
hùi	h ù i
hùm	h ù m
hùn	h ù n
hùng	h ù ng
hú	h ú
húc	h ú c
húi	h ú i
húm	h ú m
húng	h ú ng
húp	h ú p
hút	h ú t
húy	h ú y
hý	h ý
hăm	h ă m
hăng	h ă ng
hđnd	h đ n d
hđrung	h đ r u ng
hĩ	h ĩ
hĩm	h ĩ m
hĩnh	h ĩ nh
hũ	h ũ
hũm	h ũ m
hơ	h ơ
hơi	h ơ i
hơn	h ơ n
hơng	h ơ ng
hư	h ư
hưng	h ư ng
hưu	h ư u
hươm	h ươ m
hươn	h ươ n
hương	h ươ ng
hươu	h ươ u
hước	h ướ c
hướm	h ướ m
hướng	h ướ ng
hườm	h ườ m
hường	h ườ ng
hưởng	h ưở ng
hượm	h ượ m
hạ	h ạ
hạc	h ạ c
hạch	h ạ ch
hại	h ạ i
hạm	h ạ m
hạn	h ạ n
hạng	h ạ ng
hạnh	h ạ nh
hạo	h ạ o
hạp	h ạ p
hạt	h ạ t
hạy	h ạ y
hả	h ả
hải	h ả i
hảm	h ả m
hảng	h ả ng
hảnh	h ả nh
hảo	h ả o
hảy	h ả y
hấm	h ấ m
hấn	h ấ n
hấng	h ấ ng
hấp	h ấ p
hất	h ấ t
hấu	h ấ u
hấy	h ấ y
hầm	h ầ m
hầu	h ầ u
hầy	h ầ y
hẩm	h ẩ m
hẩng	h ẩ ng
hẩu	h ẩ u
hẩy	h ẩ y
hẫng	h ẫ ng
hẫu	h ẫ u
hậm	h ậ m
hận	h ậ n
hập	h ậ p
hậu	h ậ u
hắc	h ắ c
hắn	h ắ n
hắng	h ắ ng
hắt	h ắ t
hằm	h ằ m
hằn	h ằ n
hằng	h ằ ng
hẳn	h ẳ n
hẵm	h ẵ m
hẵng	h ẵ ng
hặc	h ặ c
hặm	h ặ m
hẹ	h ẹ
hẹm	h ẹ m
hẹn	h ẹ n
hẹp	h ẹ p
hẹt	h ẹ t
hẻ	h ẻ
hẻm	h ẻ m
hẻn	h ẻ n
hẻo	h ẻ o
hẽm	h ẽ m
hếch	h ế ch
hến	h ế n
hết	h ế t
hếu	h ế u
hề	h ề
hềnh	h ề nh
hều	h ề u
hể	h ể
hển	h ể n
hểnh	h ể nh
hểu	h ể u
hễ	h ễ
hệ	h ệ
hệch	h ệ ch
hệt	h ệ t
hỉ	h ỉ
hỉnh	h ỉ nh
hị	h ị
hịch	h ị ch
họ	h ọ
họa	h ọa
học	h ọ c
họe	h ọ e
họng	h ọ ng
họp	h ọ p
hỏ	h ỏ
hỏa	h ỏa
hỏi	h ỏ i
hỏiphải	h ỏ i ph ả i
hỏm	h ỏ m
hỏn	h ỏ n
hỏng	h ỏ ng
hố	h ố
hốc	h ố c
hối	h ố i
hống	h ố ng
hốt	h ố t
hồ	h ồ
hồi	h ồ i
hồn	h ồ n
hồng	h ồ ng
hổ	h ổ
hổi	h ổ i
hổm	h ổ m
hổn	h ổ n
hổng	h ổ ng
hỗ	h ỗ
hỗm	h ỗ m
hỗn	h ỗ n
hỗng	h ỗ ng
hộ	h ộ
hộc	h ộ c
hội	h ộ i
hộn	h ộ n
hộp	h ộ p
hột	h ộ t
hớ	h ớ
hớm	h ớ m
hớn	h ớ n
hớp	h ớ p
hớt	h ớ t
hờ	h ờ
hời	h ờ i
hờm	h ờ m
hờn	h ờ n
hở	h ở
hởi	h ở i
hởn	h ở n
hỡ	h ỡ
hỡi	h ỡ i
hỡm	h ỡ m
hợi	h ợ i
hợm	h ợ m
hợp	h ợ p
hợt	h ợ t
hụ	h ụ
hục	h ụ c
hụi	h ụ i
hụm	h ụ m
hụp	h ụ p
hụt	h ụ t
hủ	h ủ
hủi	h ủ i
hủm	h ủ m
hủn	h ủ n
hủng	h ủ ng
hủy	h ủ y
hứ	h ứ
hứa	h ứ a
hức	h ứ c
hứng	h ứ ng
hứt	h ứ t
hừ	h ừ
hừa	h ừ a
hừm	h ừ m
hừng	h ừ ng
hử	h ử
hửng	h ử ng
hữ	h ữ
hững	h ữ ng
hữu	h ữ u
hự	h ự
hực	h ự c
hựu	h ự u
hỷ	h ỷ
i	i
iai	i a i
ic	i c
ii	i i
iii	i i i
ilfaul	i l f a u l
im	i m
in	i n
indépendance	i n d é p e n d a n c e
ingénieux	i ng é n i e u x
inh	i nh
intranet	i n tr a n e t
inôc	i n ô c
iod	i o d
iot	i o t
italie	i t a l i e
iu	i u
iv	i v
ix	i x
iên	iê n
iúc	i ú c
iếc	iế c
iều	iề u
ja	a
jannette	a n n e t t e
jaune	a u n e
jaurès	a u r è s
javel	a v e l
jaz	a z
jor	o r
journée	o u r n é e
juif	u i f
juin	u i n
jésus	é s u s
jíp	í p
jút	ú t
jăm	ă m
ka	k a
kaki	k a k i
kali	k a l i
kalium	k a l i u m
kan	k a n
kay	k a y
kađai	k a đ a i
kcs	k c s
kde	k d e
ke	k e
kem	k e m
ken	k e n
keng	k e ng
kenvin	k e n v i n
keo	k e o
kerenski	k e r e n s k i
kg	k g
kha	kh a
khai	kh a i
kham	kh a m
khan	kh a n
khang	kh a ng
khanh	kh a nh
khao	kh a o
khau	kh a u
khay	kh a y
khe	kh e
khem	kh e m
khen	kh e n
kheo	kh e o
khi	kh i
khin	kh i n
khinh	kh i nh
khiu	kh i u
khiêm	kh iê m
khiên	kh iê n
khiêng	kh iê ng
khiêu	kh iê u
khiếm	kh iế m
khiến	kh iế n
khiếp	kh iế p
khiết	kh iế t
khiếu	kh iế u
khiền	kh iề n
khiển	kh iể n
khiểng	kh iể ng
khiễng	kh iễ ng
khiệng	kh iệ ng
khmer	kh m e r
kho	kh o
khoa	kh oa
khoai	kh oa i
khoan	kh oa n
khoang	kh oa ng
khoanh	kh oa nh
khoe	kh oe
khoen	kh oe n
khoeo	kh oe o
khoi	kh o i
khom	kh o m
khoong	kh oo ng
khoành	kh oà nh
khoào	kh oà o
khoá	kh oá
khoác	kh oá c
khoái	kh oá i
khoán	kh oá n
khoáng	kh oá ng
khoát	kh oá t
khoáy	kh oá y
khoèo	kh oè o
khoé	kh oé
khoén	kh oé n
khoét	kh oé t
khoăm	kh oă m
khoăn	kh oă n
khoăng	kh oă ng
khoạng	kh oạ ng
khoả	kh oả
khoải	kh oả i
khoản	kh oả n
khoảng	kh oả ng
khoảnh	kh oả nh
khoắm	kh oắ m
khoắn	kh oắ n
khoắng	kh oắ ng
khoắt	kh oắ t
khoằm	kh oằ m
khoặm	kh oặ m
khoẻ	kh oẻ
khoẻo	kh oẻ o
khu	kh u
khua	kh u a
khui	kh u i
khum	kh u m
khung	kh u ng
khuy	kh uy
khuya	kh uy a
khuynh	kh uy nh
khuyên	kh uyê n
khuyến	kh uyế n
khuyết	kh uyế t
khuyển	kh uyể n
khuân	kh uâ n
khuâng	kh uâ ng
khuây	kh uâ y
khuê	kh uê
khuôn	kh uô n
khuông	kh uô ng
khuýp	kh uý p
khuơ	kh uơ
khuất	kh uấ t
khuấy	kh uấ y
khuẩn	kh uẩ n
khuắng	kh u ắ ng
khuếch	kh uế ch
khuều	kh uề u
khuờ	kh uờ
khuỳnh	kh uỳ nh
khuỵ	kh uỵ
khuỵu	kh uỵ u
khuỷnh	kh uỷ nh
khuỷu	kh uỷ u
khyển	kh yể n
khà	kh à
khàn	kh à n
khàng	kh à ng
khành	kh à nh
khá	kh á
khác	kh á c
khách	kh á ch
khái	kh á i
khám	kh á m
khán	kh á n
kháng	kh á ng
khánh	kh á nh
kháo	kh á o
kháp	kh á p
khát	kh á t
kháu	kh á u
kháy	kh á y
khâm	kh â m
khân	kh â n
khâng	kh â ng
khâu	kh â u
khè	kh è
khèn	kh è n
khèng	kh è ng
khèo	kh è o
khé	kh é
khén	kh é n
khéo	kh é o
khép	kh é p
khét	kh é t
khê	kh ê
khênh	kh ê nh
khêu	kh ê u
khì	kh ì
khìn	kh ì n
khí	kh í
khía	kh í a
khích	kh í ch
khín	kh í n
khít	kh í t
khíu	kh í u
khò	kh ò
khòe	kh ò e
khòm	kh ò m
khòn	kh ò n
khòng	kh ò ng
khó	kh ó
khóa	kh óa
khóc	kh ó c
khóe	kh ó e
khói	kh ó i
khóm	kh ó m
khô	kh ô
khôi	kh ô i
khôn	kh ô n
khôn2	kh ô n
khôn3	kh ô n
không	kh ô ng
khôông	kh ô ô ng
khôống	kh ô ố ng
khù	kh ù
khùa	kh ù a
khùng	kh ù ng
khú	kh ú
khúc	kh ú c
khúm	kh ú m
khúng	kh ú ng
khăm	kh ă m
khăn	kh ă n
khăng	kh ă ng
khĩnh	kh ĩ nh
khơ	kh ơ
khơi	kh ơ i
khơme	kh ơ m e
khư	kh ư
khươi	kh ươ i
khươm	kh ươ m
khươn	kh ươ n
khương	kh ươ ng
khước	kh ướ c
khướt	kh ướ t
khướu	kh ướ u
khưởng	kh ưở ng
khưỡng	kh ưỡ ng
khượt	kh ượ t
khạ	kh ạ
khạc	kh ạ c
khạch	kh ạ ch
khạng	kh ạ ng
khạo	kh ạ o
khạp	kh ạ p
khả	kh ả
khảch	kh ả ch
khải	kh ả i
khảm	kh ả m
khản	kh ả n
khảng	kh ả ng
khảnh	kh ả nh
khảo	kh ả o
khảy	kh ả y
khấc	kh ấ c
khấm	kh ấ m
khấn	kh ấ n
khấp	kh ấ p
khất	kh ấ t
khấu	kh ấ u
khần	kh ầ n
khầng	kh ầ ng
khẩn	kh ẩ n
khẩu	kh ẩ u
khẩy	kh ẩ y
khậc	kh ậ c
khậm	kh ậ m
khập	kh ậ p
khật	kh ậ t
khắc	kh ắ c
khắm	kh ắ m
khắng	kh ắ ng
khắp	kh ắ p
khắt	kh ắ t
khằn	kh ằ n
khằng	kh ằ ng
khẳm	kh ẳ m
khẳn	kh ẳ n
khẳng	kh ẳ ng
khặc	kh ặ c
khẹc	kh ẹ c
khẻ	kh ẻ
khẻo	kh ẻ o
khẽ	kh ẽ
khế	kh ế
khề	kh ề
khềnh	kh ề nh
khều	kh ề u
khểnh	kh ể nh
khễnh	kh ễ nh
khệ	kh ệ
khệch	kh ệ ch
khệnh	kh ệ nh
khỉ	kh ỉ
khỉnh	kh ỉ nh
khị	kh ị
khịa	kh ị a
khịt	kh ị t
khọm	kh ọ m
khọt	kh ọ t
khỏ	kh ỏ
khỏa	kh ỏa
khỏe	kh ỏ e
khỏi	kh ỏ i
khỏng	kh ỏ ng
khố	kh ố
khốc	kh ố c
khối	kh ố i
khốn	kh ố n
khống	kh ố ng
khổ	kh ổ
khổn	kh ổ n
khổng	kh ổ ng
khớ	kh ớ
khới	kh ớ i
khớp	kh ớ p
khờ	kh ờ
khởi	kh ở i
khụ	kh ụ
khục	kh ụ c
khụng	kh ụ ng
khụt	kh ụ t
khụy	kh ụ y
khủ	kh ủ
khủa	kh ủ a
khủng	kh ủ ng
khứ	kh ứ
khứa	kh ứ a
khứng	kh ứ ng
khứu	kh ứ u
khừ	kh ừ
khừa	kh ừ a
khừng	kh ừ ng
khử	kh ử
khửng	kh ử ng
khự	kh ự
khựng	kh ự ng
ki	k i
kia	k i a
kilomet	k i l o m e t
kim	k i m
kin	k i n
kina	k i n a
kinh	k i nh
kinin	k i n i n
kip	k i p
kiêm	k iê m
kiên	k iê n
kiêng	k iê ng
kiêu	k iê u
kiôt	k i ô t
kiếm	k iế m
kiến	k iế n
kiếng	k iế ng
kiếp	k iế p
kiết	k iế t
kiếu	k iế u
kiềm	k iề m
kiền	k iề n
kiềng	k iề ng
kiều	k iề u
kiểm	k iể m
kiểng	k iể ng
kiểu	k iể u
kiễng	k iễ ng
kiệm	k iệ m
kiện	k iệ n
kiệt	k iệ t
kiệu	k iệ u
kk	k k
kk0	k k
km	k m
kmun	k m u n
knia	k n i a
ko	k o
koutiepoff	k o u t i e p o f f
kpă	k p ă
kpăng	k p ă ng
krang	k r a ng
kre	k r e
krem	k r e m
kruna	k r u n a
krung	k r u ng
krôm	k r ô m
krông	k r ô ng
kt	k t
ktul	k t u l
kty	k t y
ku	k u
kuênh	k uê nh
kuýp	k uý p
kw	kw
kwacha	kw a ch a
ky	k y
kyat	k y a t
káp	k á p
kè	k è
kèm	k è m
kèn	k è n
kèo	k è o
ké	k é
kéc	k é c
kém	k é m
kén	k é n
kéo	k é o
kép	k é p
két	k é t
kê	k ê
kên	k ê n
kêng	k ê ng
kênh	k ê nh
kêu	k ê u
kì	k ì
kìa	k ì a
kìm	k ì m
kìn	k ì n
kình	k ì nh
kí	k í
kích	k í ch
kín	k í n
kính	k í nh
kíp	k í p
kít	k í t
kíu	k í u
kót	k ó t
kôn	k ô n
kông	k ô ng
ký	k ý
kđrao	k đ r a o
kĩ	k ĩ
kĩn	k ĩ n
kĩu	k ĩ u
kơi	k ơ i
kạn	k ạ n
kẹ	k ẹ
kẹn	k ẹ n
kẹo	k ẹ o
kẹp	k ẹ p
kẹt	k ẹ t
kẻ	k ẻ
kẻm	k ẻ m
kẻng	k ẻ ng
kẻo	k ẻ o
kẽ	k ẽ
kẽm	k ẽ m
kẽo	k ẽ o
kế	k ế
kếch	k ế ch
kếp	k ế p
kết	k ế t
kếu	k ế u
kề	k ề
kềm	k ề m
kền	k ề n
kềnh	k ề nh
kều	k ề u
kể	k ể
kễnh	k ễ nh
kệ	k ệ
kệch	k ệ ch
kệnh	k ệ nh
kỉ	k ỉ
kỉnh	k ỉ nh
kị	k ị
kịa	k ị a
kịch	k ị ch
kịp	k ị p
kịt	k ị t
kốc	k ố c
kủo	k ủ o
kỳ	k ỳ
kỵ	k ỵ
kỷ	k ỷ
kỹ	k ỹ
la	l a
la marseillaise	l a m a r s e i l l a i s e
ladơn	l a d ơ n
lagisquet	l a gi s q u e t
lai	l a i
lalais	l a l a i s
lam	l a m
lamarseillaise	l a m a r s e i l l a i s e
lan	l a n
landri	l a n d r i
lang	l a ng
lanh	l a nh
lao	l a o
lar	l a r
lari	l a r i
lat	l a t
lati	l a t i
latti	l a t t i
lau	l a u
lavabo	l a v a b o
lay	l a y
laze	l a z e
le	l e
lem	l e m
lempira	l e m p i r a
len	l e n
leng	l e ng
leninit	l e n i n i t
leo	l e o
lesdemi	l e s d e m i
li	l i
lia	l i a
lic	l i c
lilangeni	l i l a ng e n i
lim	l i m
limier	l i m i e r
limudin	l i m u d i n
lin	l i n
linh	l i nh
lit	l i t
litas	l i t a s
lithi	l i th i
lito	l i t o
liu	l i u
liêm	l iê m
liên	l iê n
liêng	l iê ng
liêu	l iê u
liếc	l iế c
liếm	l iế m
liến	l iế n
liếng	l iế ng
liếp	l iế p
liếu	l iế u
liềm	l iề m
liền	l iề n
liềng	l iề ng
liều	l iề u
liểng	l iể ng
liễm	l iễ m
liễn	l iễ n
liễu	l iễ u
liệc	l iệ c
liệm	l iệ m
liệng	l iệ ng
liệp	l iệ p
liệt	l iệ t
liệu	l iệ u
lo	l o
loa	l oa
loai	l oa i
loan	l oa n
loang	l oa ng
loanh	l oa nh
loay	l oa y
loe	l oe
loen	l oe n
loga	l o g a
loi	l o i
lom	l o m
lon	l o n
long	l o ng
loong	l oo ng
loti	l o t i
loulou	l o u l o u
loà	l oà
loài	l oà i
loàn	l oà n
loàng	l oà ng
loá	l oá
loác	l oá c
loán	l oá n
loáng	l oá ng
loáo	l oá o
loát	l oá t
loáy	l oá y
loã	l oã
loãng	l oã ng
loè	l oè
loé	l oé
loét	l oé t
loòng	l oò ng
loăn	l oă n
loăng	l oă ng
loạc	l oạ c
loạch	l oạ ch
loại	l oạ i
loạn	l oạ n
loạng	l oạ ng
loạt	l oạ t
loả	l oả
loảng	l oả ng
loắn	l oắ n
loắt	l oắ t
loằn	l oằ n
loằng	l oằ ng
loẹt	l oẹ t
loẻng	l oẻ ng
loẻo	l oẻ o
lu	l u
lua	l u a
luang	l u a ng
lui	l u i
lum	l u m
lung	l u ng
luxe	l u x e
luy	l uy
luya	l uy a
luyn	l uy n
luyên	l uyê n
luyến	l uyế n
luyện	l uyệ n
luân	l uâ n
luôm	l uô m
luôn	l uô n
luông	l uô ng
luý	l uý
luých	l uý ch
luýnh	l uý nh
luýt	l uý t
luấn	l uấ n
luẩn	l uẩ n
luận	l uậ n
luật	l uậ t
luốc	l uố c
luống	l uố ng
luốt	l uố t
luồi	l uồ i
luồn	l uồ n
luồng	l uồ ng
luỗng	l uỗ ng
luộc	l uộ c
luộm	l uộ m
luỵ	l uỵ
luỹ	l uỹ
ly	l y
là	l à
lài	l à i
làm	l à m
làn	l à n
làng	l à ng
lành	l à nh
lào	l à o
làu	l à u
lày	l à y
lá	l á
lác	l á c
lách	l á ch
lái	l á i
lán	l á n
láng	l á ng
lánh	l á nh
láo	l á o
láp	l á p
lát	l á t
láu	l á u
láy	l á y
lâm	l â m
lân	l â n
lâng	l â ng
lâp	l â p
lâu	l â u
lây	l â y
lã	l ã
lãi	l ã i
lãm	l ã m
lãn	l ã n
lãng	l ã ng
lãnh	l ã nh
lão	l ã o
lè	l è
lèm	l è m
lèn	l è n
lèng	l è ng
lèo	l è o
lé	l é
léc	l é c
lém	l é m
lén	l é n
léng	l é ng
léo	l é o
léon	l é o n
lép	l é p
lét	l é t
lê	l ê
lêc	l ê c
lên	l ê n
lênh	l ê nh
lênin	l ê n i n
lêninit	l ê n i n i t
lêu	l ê u
lì	l ì
lìa	l ì a
lìm	l ì m
lìn	l ì n
lình	l ì nh
lìu	l ì u
lí	l í
lía	l í a
líc	l í c
lích	l í ch
lính	l í nh
líp	l í p
lít	l í t
líu	l í u
lò	l ò
lòa	l òa
lòai	l òa i
lòe	l ò e
lòi	l ò i
lòm	l ò m
lòn	l ò n
lòng	l ò ng
ló	l ó
lóa	l óa
lóc	l ó c
lóe	l ó e
lói	l ó i
lóm	l ó m
lóng	l ó ng
lóp	l ó p
lót	l ó t
lô	l ô
lôcôt	l ô c ô t
lôgic	l ô gi c
lôi	l ô i
lôm	l ô m
lôn	l ô n
lông	l ô ng
lõ	l õ
lõa	l õ a
lõi	l õ i
lõm	l õ m
lõng	l õ ng
lù	l ù
lùa	l ù a
lùi	l ù i
lùm	l ù m
lùn	l ù n
lùng	l ù ng
lú	l ú
lúa	l ú a
lúc	l ú c
lúche	l ú ch e
lúi	l ú i
lúm	l ú m
lún	l ú n
lúng	l ú ng
lúp	l ú p
lút	l ú t
lúy	l ú y
lý	l ý
lăm	l ă m
lăn	l ă n
lăng	l ă ng
lĩ	l ĩ
lĩnh	l ĩ nh
lũ	l ũ
lũa	l ũ a
lũi	l ũ i
lũm	l ũ m
lũn	l ũ n
lũng	l ũ ng
lũy	l ũ y
lơ	l ơ
lơgo	l ơ g o
lơi	l ơ i
lơm	l ơ m
lơn	l ơ n
lơng	l ơ ng
lư	l ư
lưa	l ư a
lưng	l ư ng
lưu	l ư u
lươm	l ươ m
lươn	l ươ n
lương	l ươ ng
lưới	l ướ i
lướng	l ướ ng
lướt	l ướ t
lướu	l ướ u
lười	l ườ i
lườm	l ườ m
lườn	l ườ n
lường	l ườ ng
lưởng	l ưở ng
lưỡi	l ưỡ i
lưỡng	l ưỡ ng
lược	l ượ c
lượm	l ượ m
lượn	l ượ n
lượng	l ượ ng
lượt	l ượ t
lạ	l ạ
lạc	l ạ c
lạch	l ạ ch
lại	l ạ i
lạm	l ạ m
lạn	l ạ n
lạng	l ạ ng
lạnh	l ạ nh
lạo	l ạ o
lạp	l ạ p
lạt	l ạ t
lạu	l ạ u
lạy	l ạ y
lả	l ả
lải	l ả i
lảm	l ả m
lảng	l ả ng
lảnh	l ả nh
lảo	l ả o
lảu	l ả u
lảy	l ả y
lấc	l ấ c
lấm	l ấ m
lấn	l ấ n
lấp	l ấ p
lất	l ấ t
lấu	l ấ u
lấy	l ấ y
lầm	l ầ m
lần	l ầ n
lầu	l ầ u
lầy	l ầ y
lẩm	l ẩ m
lẩn	l ẩ n
lẩu	l ẩ u
lẩy	l ẩ y
lẫm	l ẫ m
lẫn	l ẫ n
lẫy	l ẫ y
lận	l ậ n
lập	l ậ p
lật	l ậ t
lậu	l ậ u
lậy	l ậ y
lắc	l ắ c
lắm	l ắ m
lắng	l ắ ng
lắp	l ắ p
lắt	l ắ t
lằm	l ằ m
lằn	l ằ n
lằng	l ằ ng
lẳm	l ẳ m
lẳn	l ẳ n
lẳng	l ẳ ng
lẵng	l ẵ ng
lặc	l ặ c
lặm	l ặ m
lặn	l ặ n
lặng	l ặ ng
lặp	l ặ p
lặt	l ặ t
lẹ	l ẹ
lẹm	l ẹ m
lẹn	l ẹ n
lẹo	l ẹ o
lẹp	l ẹ p
lẹt	l ẹ t
lẻ	l ẻ
lẻm	l ẻ m
lẻn	l ẻ n
lẻng	l ẻ ng
lẻo	l ẻ o
lẽ	l ẽ
lẽn	l ẽ n
lẽo	l ẽ o
lếc	l ế c
lếch	l ế ch
lếp	l ế p
lết	l ế t
lếu	l ế u
lề	l ề
lềnh	l ề nh
lều	l ề u
lể	l ể
lểu	l ể u
lễ	l ễ
lệ	l ệ
lệch	l ệ ch
lệnh	l ệ nh
lệt	l ệ t
lỉm	l ỉ m
lỉnh	l ỉ nh
lỉu	l ỉ u
lị	l ị
lịa	l ị a
lịch	l ị ch
lịm	l ị m
lịnh	l ị nh
lịu	l ị u
lọ	l ọ
lọc	l ọ c
lọi	l ọ i
lọm	l ọ m
lọn	l ọ n
lọng	l ọ ng
lọp	l ọ p
lọt	l ọ t
lỏa	l ỏa
lỏi	l ỏ i
lỏm	l ỏ m
lỏn	l ỏ n
lỏng	l ỏ ng
lố	l ố
lốc	l ố c
lối	l ố i
lối lốp	l ố i l ố p
lốilốp	l ố i l ố p
lốm	l ố m
lốn	l ố n
lốp	l ố p
lốt	l ố t
lồ	l ồ
lồi	l ồ i
lồm	l ồ m
lồn	l ồ n
lồng	l ồ ng
lổ	l ổ
lổm	l ổ m
lổn	l ổ n
lổng	l ổ ng
lỗ	l ỗ
lỗi	l ỗ i
lỗm	l ỗ m
lộ	l ộ
lộc	l ộ c
lội	l ộ i
lộm	l ộ m
lộn	l ộ n
lộng	l ộ ng
lộp	l ộ p
lột	l ộ t
lớ	l ớ
lới	l ớ i
lớn	l ớ n
lớncấm	l ớ n c ấ m
lớp	l ớ p
lớt	l ớ t
lờ	l ờ
lời	l ờ i
lờm	l ờ m
lờn	l ờ n
lở	l ở
lởi	l ở i
lởm	l ở m
lởn	l ở n
lỡ	l ỡ
lỡi	l ỡ i
lỡm	l ỡ m
lợ	l ợ
lợi	l ợ i
lợm	l ợ m
lợn	l ợ n
lợp	l ợ p
lợt	l ợ t
lụ	l ụ
lụa	l ụ a
lục	l ụ c
lục đúng	l ụ c đ ú ng
lụi	l ụ i
lụm	l ụ m
lụn	l ụ n
lụng	l ụ ng
lụp	l ụ p
lụt	l ụ t
lụy	l ụ y
lủ	l ủ
lủa	l ủ a
lủi	l ủ i
lủm	l ủ m
lủn	l ủ n
lủng	l ủ ng
lứa	l ứ a
lức	l ứ c
lứt	l ứ t
lừ	l ừ
lừa	l ừ a
lừng	l ừ ng
lử	l ử
lửa	l ử a
lửng	l ử ng
lữ	l ữ
lữa	l ữ a
lững	l ữ ng
lự	l ự
lựa	l ự a
lực	l ự c
lựng	l ự ng
lựu	l ự u
lỳ	l ỳ
lỵ	l ỵ
lỹ	l ỹ
ma	m a
macketinh	m a c k e t i nh
macma	m a c m a
macxit	m a c x i t
mademoisell	m a d e m o i s e l l
madhur	m a d h u r
magazin	m a g a z i n
magnetit	m a g n e t i t
magneto	m a g n e t o
magnésium	m a g n é s i u m
magnêsium	m a g n ê s i u m
mai	m a i
mailène	m a i l è n e
maket	m a k e t
malang	m a l a ng
malheureux	m a l h e u r e u x
malraux	m a l r a u x
malthus	m a l th u s
maltos	m a l t o s
mam	m a m
maman	m a m a n
mammuth	m a m m u th
man	m a n
manat	m a n a t
mang	m a ng
manh	m a nh
manhetit	m a nh e t i t
manheto	m a nh e t o
manip	m a n i p
maniven	m a n i v e n
mantoza	m a n t o z a
manơcanh	m a n ơ c a nh
mao	m a o
mareilaise	m a r e i l a i s e
margueritte	m a r g u e r i t t e
marlel	m a r l e l
marseillaise	m a r s e i l l a i s e
marxit	m a r x i t
mastic	m a s t i c
mathide	m a th i d e
mattit	m a t t i t
matxa	m a t x a
mau	m a u
maunce	m a u n c e
maupassant	m a u p a s s a n t
maupasạant	m a u p a s ạ a n t
maurras	m a u r r a s
may	m a y
mayso	m a y s o
mazut	m a z u t
me	m e
mem	m e m
men	m e n
meo	m e o
mephisto	m e ph i s t o
metan	m e t a n
metical	m e t i c a l
mezon	m e z o n
mg	m g
mi	m i
mia	m i a
mili	m i l i
mim	m i m
min	m i n
minh	m i nh
mintoa	m i n t oa
mittinh	m i t t i nh
miu	m i u
miên	m iê n
miêu	m iê u
miẻo	m i ẻ o
miến	m iế n
miếng	m iế ng
miết	m iế t
miếu	m iế u
miền	m iề n
miều	m iề u
miểng	m iể ng
miễn	m iễ n
miễu	m iễ u
miện	m iệ n
miệng	m iệ ng
miệt	m iệ t
mm	m m
mn	m n
mo	m o
moa	m oa
moan	m oa n
moay	m oa y
mobilet	m o b i l e t
moi	m o i
mom	m o m
momo	m o m o
mon	m o n
mondel	m o n d e l
mong	m o ng
monome	m o n o m e
monpère	m o n p è r e
monsteur	m o n s t e u r
montaigne	m o n t a i g n e
moong	m oo ng
morat	m o r a t
mors	m o r s
moscou	m o s c o u
mossant	m o s s a n t
moutet	m o u t e t
moóc	m oó c
moạcou	m oạ c o u
moọc	m oọ c
mrơn	m r ơ n
mu	m u
mua	m u a
mual	m u a l
mui	m u i
mum	m u m
mun	m u n
mung	m u ng
musséc	m u s s é c
mutuel	m u t u e l
muy	m uy
muya	m uy a
muôi	m uô i
muôn	m uô n
muông	m uô ng
muối	m uố i
muốn	m uố n
muống	m uố ng
muốt	m uố t
muồi	m uồ i
muồm	m uồ m
muồng	m uồ ng
muỗi	m uỗ i
muỗm	m uỗ m
muỗng	m uỗ ng
muội	m uộ i
muộn	m uộ n
my	m y
mà	m à
mài	m à i
màn	m à n
màng	m à ng
mành	m à nh
mào	m à o
màu	m à u
mày	m à y
má	m á
mác	m á c
mách	m á ch
mái	m á i
mám	m á m
mán	m á n
máng	m á ng
mánh	m á nh
máo	m á o
mát	m á t
máu	m á u
máy	m á y
mâm	m â m
mân	m â n
mâng	m â ng
mâp	m â p
mâu	m â u
mây	m â y
mã	m ã
mãi	m ã i
mãn	m ã n
mãng	m ã ng
mãnh	m ã nh
mão	m ã o
mè	m è
mèm	m è m
mèn	m è n
mèng	m è ng
mèo	m è o
mé	m é
méc	m é c
mém	m é m
mén	m é n
méo	m é o
mép	m é p
mét	m é t
métier	m é t i e r
mê	m ê
même	m ê m e
mên	m ê n
mênh	m ê nh
mì	m ì
mìn	m ì n
mình	m ì nh
mí	m í
mía	m í a
mích	m í ch
mím	m í m
míp	m í p
mít	m í t
míu	m í u
mò	m ò
mòi	m ò i
mòm	m ò m
mòn	m ò n
mòng	m ò ng
mó	m ó
móc	m ó c
mói	m ó i
móm	m ó m
món	m ó n
móng	m ó ng
móp	m ó p
mót	m ó t
mô	m ô
môbilet	m ô b i l e t
môi	m ô i
môm	m ô m
môn	m ô n
mông	m ô ng
môt	m ô t
môtip	m ô t i p
mõ	m õ
mõm	m õ m
mù	m ù
mùa	m ù a
mùi	m ù i
mùn	m ù n
mùng	m ù ng
mú	m ú
múa	m ú a
múc	m ú c
múi	m ú i
múm	m ú m
mún	m ú n
múp	m ú p
mút	m ú t
măk	m ă k
măm	m ă m
măn	m ă n
măng	m ă ng
măng sông	m ă ng s ô ng
măng tô	m ă ng t ô
măngđa	m ă ng đ a
mđhur	m đ h u r
mĩ	m ĩ
mĩm	m ĩ m
mũ	m ũ
mũi	m ũ i
mũm	m ũ m
mơ	m ơ
mơi	m ơ i
mơm	m ơ m
mơn	m ơ n
mơnuy	m ơ n uy
mưa	m ư a
mưng	m ư ng
mưu	m ư u
mươi	m ươ i
mươn	m ươ n
mương	m ươ ng
mướn	m ướ n
mướp	m ướ p
mướt	m ướ t
mười	m ườ i
mườn	m ườ n
mường	m ườ ng
mưỡu	m ưỡ u
mược	m ượ c
mượn	m ượ n
mượt	m ượ t
mạ	m ạ
mạc	m ạ c
mạch	m ạ ch
mại	m ạ i
mạn	m ạ n
mạng	m ạ ng
mạnh	m ạ nh
mạo	m ạ o
mạp	m ạ p
mạt	m ạ t
mạy	m ạ y
mả	m ả
mải	m ả i
mảng	m ả ng
mảnh	m ả nh
mảy	m ả y
mấm	m ấ m
mấn	m ấ n
mấp	m ấ p
mất	m ấ t
mấu	m ấ u
mấy	m ấ y
mầm	m ầ m
mần	m ầ n
mầng	m ầ ng
mầu	m ầ u
mầungoài	m ầ u ng oà i
mầy	m ầ y
mẩm	m ẩ m
mẩn	m ẩ n
mẩu	m ẩ u
mẩy	m ẩ y
mẫm	m ẫ m
mẫn	m ẫ n
mẫu	m ẫ u
mậm	m ậ m
mận	m ậ n
mập	m ậ p
mật	m ậ t
mậu	m ậ u
mậy	m ậ y
mắc	m ắ c
mắm	m ắ m
mắn	m ắ n
mắng	m ắ ng
mắt	m ắ t
mằn	m ằ n
mẳn	m ẳ n
mẵm	m ẵ m
mặc	m ặ c
mặn	m ặ n
mặt	m ặ t
mẹ	m ẹ
mẹc	m ẹ c
mẹo	m ẹ o
mẹp	m ẹ p
mẹt	m ẹ t
mẻ	m ẻ
mẻng	m ẻ ng
mẻo	m ẻ o
mẽ	m ẽ
mế	m ế
mếch	m ế ch
mến	m ế n
mết	m ế t
mếu	m ế u
mề	m ề
mềm	m ề m
mền	m ề n
mể	m ể
mễ	m ễ
mệ	m ệ
mệnh	m ệ nh
mệt	m ệ t
mỉ	m ỉ
mỉa	m ỉ a
mỉm	m ỉ m
mỉu	m ỉ u
mị	m ị
mịch	m ị ch
mịn	m ị n
mịnh	m ị nh
mịt	m ị t
mọ	m ọ
mọc	m ọ c
mọi	m ọ i
mọn	m ọ n
mọng	m ọ ng
mọp	m ọ p
mọt	m ọ t
mỏ	m ỏ
mỏi	m ỏ i
mỏm	m ỏ m
mỏng	m ỏ ng
mố	m ố
mốc	m ố c
mối	m ố i
mống	m ố ng
mốt	m ố t
mồ	m ồ
mồi	m ồ i
mồm	m ồ m
mồn	m ồ n
mồng	m ồ ng
mổ	m ổ
mổng	m ổ ng
mỗ	m ỗ
mỗi	m ỗ i
mộ	m ộ
mộc	m ộ c
mội	m ộ i
mộng	m ộ ng
mộng triệu	m ộ ng tr iệ u
một	m ộ t
mớ	m ớ
mới	m ớ i
mớm	m ớ m
mớn	m ớ n
mớp	m ớ p
mờ	m ờ
mời	m ờ i
mờm	m ờ m
mở	m ở
mởn	m ở n
mỡ	m ỡ
mợ	m ợ
mụ	m ụ
mục	m ụ c
mụi	m ụ i
mụn	m ụ n
mụp	m ụ p
mụt	m ụ t
mủ	m ủ
mủi	m ủ i
mủm	m ủ m
mủn	m ủ n
mủng	m ủ ng
mứa	m ứ a
mức	m ứ c
mứn	m ứ n
mứt	m ứ t
mứu	m ứ u
mừng	m ừ ng
mửa	m ử a
mửng	m ử ng
mự	m ự
mựa	m ự a
mực	m ự c
mỳ	m ỳ
mỵ	m ỵ
mỷ	m ỷ
mỹ	m ỹ
na	n a
nai	n a i
naille	n a i l l e
nakfa	n a k f a
nam	n a m
nan	n a n
nang	n a ng
nanh	n a nh
nao	n a o
naphthalen	n a ph th a l e n
nat	n a t
natri	n a tr i
nau	n a u
nay	n a y
ne	n e
nem	n e m
nen	n e n
neo	n e o
neon	n e o n
ner	n e r
nga	ng a
ngai	ng a i
ngam	ng a m
ngan	ng a n
ngang	ng a ng
nganh	ng a nh
ngao	ng a o
ngau	ng a u
ngay	ng a y
nge	ng e
nghe	ngh e
nghen	ngh e n
ngheo	ngh e o
nghi	ngh i
nghim	ngh i m
nghin	ngh i n
nghinh	ngh i nh
nghiu	ngh i u
nghiêm	ngh iê m
nghiên	ngh iê n
nghiêng	ngh iê ng
nghiêu	ngh iê u
nghiến	ngh iế n
nghiền	ngh iề n
nghiễm	ngh iễ m
nghiệm	ngh iệ m
nghiện	ngh iệ n
nghiệp	ngh iệ p
nghiệt	ngh iệ t
nghè	ngh è
nghèn	ngh è n
nghèo	ngh è o
nghé	ngh é
nghén	ngh é n
nghét	ngh é t
nghê	ngh ê
nghêng	ngh ê ng
nghênh	ngh ê nh
nghêu	ngh ê u
nghì	ngh ì
nghìn	ngh ì n
nghí	ngh í
nghía	ngh í a
nghít	ngh í t
nghĩ	ngh ĩ
nghĩa	ngh ĩ a
nghĩnh	ngh ĩ nh
nghẹ	ngh ẹ
nghẹn	ngh ẹ n
nghẹo	ngh ẹ o
nghẹt	ngh ẹ t
nghẻ	ngh ẻ
nghẻn	ngh ẻ n
nghẻo	ngh ẻ o
nghẽn	ngh ẽ n
nghẽo	ngh ẽ o
nghếch	ngh ế ch
nghến	ngh ế n
nghề	ngh ề
nghền	ngh ề n
nghềnh	ngh ề nh
nghều	ngh ề u
nghể	ngh ể
nghển	ngh ể n
nghểnh	ngh ể nh
nghểu	ngh ể u
nghễ	ngh ễ
nghễnh	ngh ễ nh
nghễu	ngh ễ u
nghệ	ngh ệ
nghệch	ngh ệ ch
nghện	ngh ệ n
nghệt	ngh ệ t
nghệu	ngh ệ u
nghỉ	ngh ỉ
nghỉm	ngh ỉ m
nghỉn	ngh ỉ n
nghỉnh	ngh ỉ nh
nghỉu	ngh ỉ u
nghị	ngh ị
nghịch	ngh ị ch
nghịnh	ngh ị nh
nghịt	ngh ị t
nghịu	ngh ị u
ngo	ng o
ngoa	ng oa
ngoai	ng oa i
ngoam	ng oa m
ngoan	ng oa n
ngoang	ng oa ng
ngoay	ng oa y
ngoe	ng oe
ngoem	ng oe m
ngoen	ng oe n
ngoeo	ng oe o
ngoi	ng o i
ngoisao	ng o i s a o
ngon	ng o n
ngong	ng o ng
ngoong	ng oo ng
ngoài	ng oà i
ngoàm	ng oà m
ngoác	ng oá c
ngoách	ng oá ch
ngoái	ng oá i
ngoáo	ng oá o
ngoáy	ng oá y
ngoã	ng oã
ngoãn	ng oã n
ngoèo	ng oè o
ngoé	ng oé
ngoém	ng oé m
ngoén	ng oé n
ngoéo	ng oé o
ngoét	ng oé t
ngoăn	ng oă n
ngoăng	ng oă ng
ngoạ	ng oạ
ngoạc	ng oạ c
ngoạch	ng oạ ch
ngoại	ng oạ i
ngoạm	ng oạ m
ngoạn	ng oạ n
ngoạp	ng oạ p
ngoạy	ng oạ y
ngoải	ng oả i
ngoảm	ng oả m
ngoảnh	ng oả nh
ngoảy	ng oả y
ngoắc	ng oắ c
ngoắt	ng oắ t
ngoằn	ng oằ n
ngoằng	ng oằ ng
ngoẳn	ng oẳ n
ngoẳng	ng oẳ ng
ngoẵng	ng oẵ ng
ngoặc	ng oặ c
ngoặm	ng oặ m
ngoặt	ng oặ t
ngoẹo	ng oẹ o
ngoẻm	ng oẻ m
ngoẻn	ng oẻ n
ngoẻo	ng oẻ o
ngu	ng u
ngultrum	ng u l tr u m
ngun	ng u n
nguoi	ng u o i
nguy	ng uy
nguyên	ng uyê n
nguyền	ng uyề n
nguyễn	ng uyễ n
nguyện	ng uyệ n
nguyệt	ng uyệ t
nguây	ng uâ y
nguôi	ng uô i
nguých	ng uý ch
nguýt	ng uý t
nguầy	ng uầ y
nguẩy	ng uẩ y
nguậy	ng uậ y
nguếch	ng uế ch
nguệch	ng uệ ch
nguồi	ng uồ i
nguồn	ng uồ n
nguội	ng uộ i
nguỳ	ng uỳ
nguỵ	ng uỵ
nguỷu	ng uỷ u
ngà	ng à
ngài	ng à i
ngàm	ng à m
ngàn	ng à n
ngàng	ng à ng
ngành	ng à nh
ngào	ng à o
ngày	ng à y
ngác	ng á c
ngách	ng á ch
ngái	ng á i
ngám	ng á m
ngán	ng á n
ngáng	ng á ng
ngáo	ng á o
ngáp	ng á p
ngát	ng á t
ngáu	ng á u
ngáy	ng á y
ngâm	ng â m
ngân	ng â n
ngâu	ng â u
ngây	ng â y
ngã	ng ã
ngãi	ng ã i
ngãng	ng ã ng
ngão	ng ã o
ngía	ng í a
ngò	ng ò
ngòi	ng ò i
ngòm	ng ò m
ngòn	ng ò n
ngòng	ng ò ng
ngó	ng ó
ngóc	ng ó c
ngóe	ng ó e
ngóeo	ng ó e o
ngói	ng ó i
ngóm	ng ó m
ngón	ng ó n
ngóng	ng ó ng
ngóp	ng ó p
ngót	ng ó t
ngô	ng ô
ngôi	ng ô i
ngôn	ng ô n
ngông	ng ô ng
ngõ	ng õ
ngõa	ng õ a
ngõng	ng õ ng
ngù	ng ù
ngùi	ng ù i
ngùn	ng ù n
ngùng	ng ù ng
ngú	ng ú
ngúc	ng ú c
ngún	ng ú n
ngúng	ng ú ng
ngút	ng ú t
ngăm	ng ă m
ngăn	ng ă n
ngũ	ng ũ
ngơ	ng ơ
ngơi	ng ơ i
ngơm	ng ơ m
ngơn	ng ơ n
ngư	ng ư
ngưa	ng ư a
ngưng	ng ư ng
ngưu	ng ư u
ngươi	ng ươ i
ngươn	ng ươ n
ngước	ng ướ c
người	ng ườ i
ngường	ng ườ ng
ngưởng	ng ưở ng
ngưỡng	ng ưỡ ng
ngược	ng ượ c
ngượng	ng ượ ng
ngạc	ng ạ c
ngạch	ng ạ ch
ngại	ng ạ i
ngạn	ng ạ n
ngạnh	ng ạ nh
ngạo	ng ạ o
ngạt	ng ạ t
ngả	ng ả
ngải	ng ả i
ngảng	ng ả ng
ngảnh	ng ả nh
ngảo	ng ả o
ngấc	ng ấ c
ngấm	ng ấ m
ngấn	ng ấ n
ngấp	ng ấ p
ngất	ng ấ t
ngấu	ng ấ u
ngấy	ng ấ y
ngầm	ng ầ m
ngần	ng ầ n
ngầu	ng ầ u
ngầy	ng ầ y
ngẩm	ng ẩ m
ngẩn	ng ẩ n
ngẩng	ng ẩ ng
ngẩu	ng ẩ u
ngẫm	ng ẫ m
ngẫn	ng ẫ n
ngẫu	ng ẫ u
ngậm	ng ậ m
ngận	ng ậ n
ngập	ng ậ p
ngật	ng ậ t
ngậu	ng ậ u
ngậy	ng ậ y
ngắc	ng ắ c
ngắm	ng ắ m
ngắn	ng ắ n
ngắt	ng ắ t
ngằn	ng ằ n
ngẳn	ng ẳ n
ngẳng	ng ẳ ng
ngẵng	ng ẵ ng
ngặt	ng ặ t
ngịu	ng ị u
ngọ	ng ọ
ngọc	ng ọ c
ngọn	ng ọ n
ngọng	ng ọ ng
ngọt	ng ọ t
ngỏ	ng ỏ
ngỏm	ng ỏ m
ngỏn	ng ỏ n
ngỏng	ng ỏ ng
ngố	ng ố
ngốc	ng ố c
ngốn	ng ố n
ngốt	ng ố t
ngồ	ng ồ
ngồi	ng ồ i
ngồm	ng ồ m
ngồn	ng ồ n
ngồng	ng ồ ng
ngổ	ng ổ
ngổm	ng ổ m
ngổn	ng ổ n
ngổng	ng ổ ng
ngỗ	ng ỗ
ngỗi	ng ỗ i
ngỗng	ng ỗ ng
ngộ	ng ộ
ngộc	ng ộ c
ngộn	ng ộ n
ngộp	ng ộ p
ngột	ng ộ t
ngớ	ng ớ
ngớn	ng ớ n
ngớp	ng ớ p
ngớt	ng ớ t
ngờ	ng ờ
ngời	ng ờ i
ngờm	ng ờ m
ngởn	ng ở n
ngỡ	ng ỡ
ngỡi	ng ỡ i
ngỡn	ng ỡ n
ngợ	ng ợ
ngợi	ng ợ i
ngợm	ng ợ m
ngợp	ng ợ p
ngụ	ng ụ
ngụa	ng ụ a
ngục	ng ụ c
ngụm	ng ụ m
ngụp	ng ụ p
ngụt	ng ụ t
ngụy	ng ụ y
ngủ	ng ủ
ngủi	ng ủ i
ngủm	ng ủ m
ngủn	ng ủ n
ngủng	ng ủ ng
ngứ	ng ứ
ngứa	ng ứ a
ngứng	ng ứ ng
ngừ	ng ừ
ngừa	ng ừ a
ngừng	ng ừ ng
ngửa	ng ử a
ngửi	ng ử i
ngửng	ng ử ng
ngữ	ng ữ
ngự	ng ự
ngựa	ng ự a
ngực	ng ự c
nha	nh a
nhai	nh a i
nham	nh a m
nhan	nh a n
nhang	nh a ng
nhanh	nh a nh
nhao	nh a o
nhau	nh a u
nhay	nh a y
nhe	nh e
nhem	nh e m
nhen	nh e n
nheo	nh e o
nhi	nh i
nhinh	nh i nh
nhip	nh i p
nhiu	nh i u
nhiên	nh iê n
nhiêu	nh iê u
nhiếc	nh iế c
nhiếp	nh iế p
nhiề	nh iề
nhiều	nh iề u
nhiễm	nh iễ m
nhiễn	nh iễ n
nhiễu	nh iễ u
nhiệm	nh iệ m
nhiệt	nh iệ t
nho	nh o
nhoai	nh oa i
nhoang	nh oa ng
nhoe	nh oe
nhoen	nh oe n
nhoi	nh o i
nhom	nh o m
nhon	nh o n
nhong	nh o ng
nhoà	nh oà
nhoài	nh oà i
nhoàm	nh oà m
nhoàng	nh oà ng
nhoá	nh oá
nhoáng	nh oá ng
nhoáy	nh oá y
nhoè	nh oè
nhoèn	nh oè n
nhoé	nh oé
nhoét	nh oé t
nhoạng	nh oạ ng
nhoằng	nh oằ ng
nhoẹt	nh oẹ t
nhoẻn	nh oẻ n
nhu	nh u
nhui	nh u i
nhum	nh u m
nhun	nh u n
nhung	nh u ng
nhuyễn	nh uyễ n
nhuôm	nh uô m
nhuần	nh uầ n
nhuận	nh uậ n
nhuế	nh uế
nhuệ	nh uệ
nhuốc	nh uố c
nhuốm	nh uố m
nhuộm	nh uộ m
nhuỵ	nh uỵ
nhà	nh à
nhài	nh à i
nhàm	nh à m
nhàn	nh à n
nhàng	nh à ng
nhành	nh à nh
nhào	nh à o
nhàu	nh à u
nhày	nh à y
nhá	nh á
nhác	nh á c
nhách	nh á ch
nhái	nh á i
nhám	nh á m
nháng	nh á ng
nhánh	nh á nh
nháo	nh á o
nháp	nh á p
nhát	nh á t
nháu	nh á u
nháy	nh á y
nhâm	nh â m
nhân	nh â n
nhâng	nh â ng
nhâu	nh â u
nhây	nh â y
nhã	nh ã
nhãi	nh ã i
nhãn	nh ã n
nhãng	nh ã ng
nhão	nh ã o
nhè	nh è
nhèm	nh è m
nhèn	nh è n
nhèo	nh è o
nhé	nh é
nhém	nh é m
nhén	nh é n
nhéo	nh é o
nhép	nh é p
nhét	nh é t
nhê	nh ê
nhênh	nh ê nh
nhì	nh ì
nhìn	nh ì n
nhìu	nh ì u
nhí	nh í
nhía	nh í a
nhích	nh í ch
nhím	nh í m
nhín	nh í n
nhính	nh í nh
nhíp	nh í p
nhít	nh í t
nhíu	nh í u
nhò	nh ò
nhòa	nh òa
nhòe	nh ò e
nhòm	nh ò m
nhòng	nh ò ng
nhó	nh ó
nhóa	nh óa
nhóc	nh ó c
nhóe	nh ó e
nhói	nh ó i
nhóm	nh ó m
nhón	nh ó n
nhóng	nh ó ng
nhóp	nh ó p
nhót	nh ó t
nhô	nh ô
nhôi	nh ô i
nhôm	nh ô m
nhôn	nh ô n
nhông	nh ô ng
nhõ	nh õ
nhõi	nh õ i
nhõm	nh õ m
nhõn	nh õ n
nhõng	nh õ ng
nhù	nh ù
nhùi	nh ù i
nhùn	nh ù n
nhùng	nh ù ng
nhú	nh ú
nhúa	nh ú a
nhúc	nh ú c
nhúi	nh ú i
nhúm	nh ú m
nhún	nh ú n
nhúng	nh ú ng
nhút	nh ú t
nhăm	nh ă m
nhăn	nh ă n
nhăng	nh ă ng
nhĩ	nh ĩ
nhũ	nh ũ
nhũn	nh ũ n
nhũng	nh ũ ng
nhơ	nh ơ
nhơi	nh ơ i
nhơm	nh ơ m
nhơn	nh ơ n
như	nh ư
nhưng	nh ư ng
nhương	nh ươ ng
nhướn	nh ướ n
nhướng	nh ướ ng
nhường	nh ườ ng
nhưỡng	nh ưỡ ng
nhược	nh ượ c
nhượng	nh ượ ng
nhạc	nh ạ c
nhại	nh ạ i
nhạn	nh ạ n
nhạng	nh ạ ng
nhạnh	nh ạ nh
nhạo	nh ạ o
nhạp	nh ạ p
nhạt	nh ạ t
nhạy	nh ạ y
nhả	nh ả
nhải	nh ả i
nhảm	nh ả m
nhản	nh ả n
nhảnh	nh ả nh
nhảu	nh ả u
nhảy	nh ả y
nhấc	nh ấ c
nhấm	nh ấ m
nhấn	nh ấ n
nhấp	nh ấ p
nhất	nh ấ t
nhấu	nh ấ u
nhấy	nh ấ y
nhầm	nh ầ m
nhần	nh ầ n
nhầu	nh ầ u
nhầy	nh ầ y
nhẩm	nh ẩ m
nhẩn	nh ẩ n
nhẩu	nh ẩ u
nhẩy	nh ẩ y
nhẫm	nh ẫ m
nhẫn	nh ẫ n
nhẫy	nh ẫ y
nhậm	nh ậ m
nhận	nh ậ n
nhập	nh ậ p
nhật	nh ậ t
nhậu	nh ậ u
nhậy	nh ậ y
nhắc	nh ắ c
nhắm	nh ắ m
nhắn	nh ắ n
nhắng	nh ắ ng
nhắp	nh ắ p
nhắt	nh ắ t
nhằm	nh ằ m
nhằn	nh ằ n
nhằng	nh ằ ng
nhẳn	nh ẳ n
nhẳng	nh ẳ ng
nhẵn	nh ẵ n
nhẵng	nh ẵ ng
nhặm	nh ặ m
nhặn	nh ặ n
nhặng	nh ặ ng
nhặt	nh ặ t
nhẹ	nh ẹ
nhẹm	nh ẹ m
nhẹn	nh ẹ n
nhẹo	nh ẹ o
nhẹp	nh ẹ p
nhẹt	nh ẹ t
nhẻ	nh ẻ
nhẻm	nh ẻ m
nhẻo	nh ẻ o
nhẽ	nh ẽ
nhẽo	nh ẽ o
nhế	nh ế
nhếch	nh ế ch
nhếu	nh ế u
nhể	nh ể
nhểu	nh ể u
nhễ	nh ễ
nhệch	nh ệ ch
nhện	nh ệ n
nhệu	nh ệ u
nhỉ	nh ỉ
nhỉnh	nh ỉ nh
nhỉu	nh ỉ u
nhị	nh ị
nhịa	nh ị a
nhịn	nh ị n
nhịp	nh ị p
nhịt	nh ị t
nhịu	nh ị u
nhọ	nh ọ
nhọc	nh ọ c
nhọn	nh ọ n
nhọt	nh ọ t
nhỏ	nh ỏ
nhỏm	nh ỏ m
nhỏng	nh ỏ ng
nhố	nh ố
nhốc	nh ố c
nhối	nh ố i
nhốn	nh ố n
nhốp	nh ố p
nhốt	nh ố t
nhồi	nh ồ i
nhồm	nh ồ m
nhồn	nh ồ n
nhồng	nh ồ ng
nhổ	nh ổ
nhổm	nh ổ m
nhổn	nh ổ n
nhổng	nh ổ ng
nhội	nh ộ i
nhộn	nh ộ n
nhộng	nh ộ ng
nhột	nh ộ t
nhớ	nh ớ
nhớm	nh ớ m
nhớn	nh ớ n
nhớp	nh ớ p
nhớt	nh ớ t
nhờ	nh ờ
nhời	nh ờ i
nhờm	nh ờ m
nhờn	nh ờ n
nhở	nh ở
nhởi	nh ở i
nhởn	nh ở n
nhỡ	nh ỡ
nhỡn	nh ỡ n
nhợ	nh ợ
nhợn	nh ợ n
nhợt	nh ợ t
nhụ	nh ụ
nhụa	nh ụ a
nhục	nh ụ c
nhụi	nh ụ i
nhụng	nh ụ ng
nhụt	nh ụ t
nhụy	nh ụ y
nhủ	nh ủ
nhủi	nh ủ i
nhủn	nh ủ n
nhủng	nh ủ ng
nhứ	nh ứ
nhức	nh ứ c
nhứt	nh ứ t
nhừ	nh ừ
nhừng	nh ừ ng
nhử	nh ử
nhữ	nh ữ
nhữg	nh ữ g
những	nh ữ ng
nhựa	nh ự a
nhựt	nh ự t
ni	n i
nia	n i a
nic	n i c
niken	n i k e n
nilông	n i l ô ng
nin	n i n
ninh	n i nh
nit	n i t
nitrat	n i tr a t
niu	n i u
niutơn	n i u t ơ n
niêm	n iê m
niên	n iê n
niêng	n iê ng
niêu	n iê u
niết	n iế t
niềm	n iề m
niền	n iề n
niềng	n iề ng
niễng	n iễ ng
niệm	n iệ m
niệt	n iệ t
niệu	n iệ u
no	n o
noa	n oa
nohay	n o h a y
noi	n o i
nom	n o m
non	n o n
nong	n o ng
noong	n oo ng
nos	n o s
noãn	n oã n
noé	n oé
nsnd	n s n d
nsưt	n s ư t
nt	n t
nu	n u
nua	n u a
nui	n u i
num	n u m
nung	n u ng
nuy	n uy
nuôi	n uô i
nuông	n uô ng
nuốc	n uố c
nuối	n uố i
nuốm	n uố m
nuốt	n uố t
nuộc	n uộ c
nuột	n uộ t
nxb	n x b
nà	n à
nài	n à i
nàm	n à m
nàn	n à n
nàng	n à ng
nành	n à nh
nào	n à o
này	n à y
ná	n á
nác	n á c
nách	n á ch
nái	n á i
nám	n á m
nán	n á n
náng	n á ng
nánh	n á nh
náo	n á o
náp	n á p
nát	n á t
náu	n á u
náy	n á y
nâm	n â m
nân	n â n
nâng	n â ng
nâu	n â u
nây	n â y
nã	n ã
nãi	n ã i
não	n ã o
nãy	n ã y
nè	n è
nèo	n è o
né	n é
nécessifeux	n é c e s s i f e u x
nécessiteux	n é c e s s i t e u x
ném	n é m
nén	n é n
néo	n é o
nép	n é p
nét	n é t
nê	n ê
nêm	n ê m
nên	n ê n
nênh	n ê nh
nêu	n ê u
nì	n ì
nình	n ì nh
ní	n í
níc	n í c
ních	n í ch
nín	n í n
nính	n í nh
níp	n í p
nít	n í t
níu	n í u
nò	n ò
nòi	n ò i
nòm	n ò m
nòng	n ò ng
nó	n ó
nóc	n ó c
nói	n ó i
nón	n ó n
nóng	n ó ng
nóp	n ó p
nót	n ó t
nô	n ô
nôen	n ô e n
nôi	n ô i
nôm	n ô m
nôn	n ô n
nông	n ô ng
nõ	n õ
nõn	n õ n
nùi	n ù i
nùn	n ù n
nùng	n ù ng
nú	n ú
núa	n ú a
núc	n ú c
núi	n ú i
núm	n ú m
núng	n ú ng
núp	n ú p
nút	n ú t
năm	n ă m
năn	n ă n
năng	n ă ng
nĩa	n ĩ a
nũa	n ũ a
nũng	n ũ ng
nơ	n ơ
nơi	n ơ i
nơm	n ơ m
nơron	n ơ r o n
nơtron	n ơ tr o n
nư	n ư
nưa	n ư a
nưng	n ư ng
nương	n ươ ng
nước	n ướ c
nướng	n ướ ng
nườm	n ườ m
nường	n ườ ng
nược	n ượ c
nượp	n ượ p
nạ	n ạ
nạc	n ạ c
nại	n ạ i
nạm	n ạ m
nạn	n ạ n
nạng	n ạ ng
nạnh	n ạ nh
nạo	n ạ o
nạp	n ạ p
nạt	n ạ t
nạy	n ạ y
nả	n ả
nải	n ả i
nản	n ả n
nảo	n ả o
nảy	n ả y
nấc	n ấ c
nấm	n ấ m
nấn	n ấ n
nấng	n ấ ng
nấp	n ấ p
nấu	n ấ u
nấy	n ấ y
nầm	n ầ m
nần	n ầ n
nầy	n ầ y
nẩy	n ẩ y
nẫm	n ẫ m
nẫn	n ẫ n
nẫng	n ẫ ng
nẫu	n ẫ u
nẫy	n ẫ y
nậm	n ậ m
nậng	n ậ ng
nập	n ậ p
nậu	n ậ u
nậy	n ậ y
nắc	n ắ c
nắm	n ắ m
nắn	n ắ n
nắng	n ắ ng
nắp	n ắ p
nằm	n ằ m
nằn	n ằ n
nằng	n ằ ng
nẵng	n ẵ ng
nặc	n ặ c
nặn	n ặ n
nặng	n ặ ng
nẹ	n ẹ
nẹp	n ẹ p
nẹt	n ẹ t
nẻ	n ẻ
nẻo	n ẻ o
nếm	n ế m
nến	n ế n
nếp	n ế p
nết	n ế t
nếu	n ế u
nề	n ề
nền	n ề n
nể	n ể
nệ	n ệ
nệm	n ệ m
nện	n ệ n
nệp	n ệ p
nỉ	n ỉ
nị	n ị
nịch	n ị ch
nịnh	n ị nh
nịt	n ị t
nịu	n ị u
nọ	n ọ
nọc	n ọ c
nọi	n ọ i
nọn	n ọ n
nọng	n ọ ng
nọt	n ọ t
nỏ	n ỏ
nỏi	n ỏ i
nỏm	n ỏ m
nố	n ố
nốc	n ố c
nối	n ố i
nống	n ố ng
nốp	n ố p
nốt	n ố t
nồ	n ồ
nồi	n ồ i
nồm	n ồ m
nồng	n ồ ng
nổ	n ổ
nổi	n ổ i
nổng	n ổ ng
nỗ	n ỗ
nỗi	n ỗ i
nỗng	n ỗ ng
nộ	n ộ
nộc	n ộ c
nội	n ộ i
nộm	n ộ m
nộn	n ộ n
nộp	n ộ p
nột	n ộ t
nớ	n ớ
nới	n ớ i
nớp	n ớ p
nớt	n ớ t
nờ	n ờ
nờm	n ờ m
nở	n ở
nỡ	n ỡ
nỡm	n ỡ m
nợ	n ợ
nụ	n ụ
nục	n ụ c
nủa	n ủ a
nứa	n ứ a
nức	n ứ c
nứng	n ứ ng
nứt	n ứ t
nừng	n ừ ng
nử	n ử
nửa	n ử a
nữ	n ữ
nữa	n ữ a
nự	n ự
nực	n ự c
nựng	n ự ng
o	o
o2	o
oa	oa
oai	oa i
oan	oa n
oang	oa ng
oanh	oa nh
octobre	o c t o b r e
oe	oe
oeng	oe ng
oeo	oe o
oi	o i
oise	o i s e
olimpic	o l i m p i c
om	o m
omicron	o m i c r o n
omme	o m m e
on	o n
ong	o ng
oong	oo ng
opset	o p s e t
orchidéc	o r ch i d é c
orléans	o r l é a n s
orăng	o r ă ng
oto ray	o t o r a y
ouguiya	o u g u i y a
oxi	o x i
oxid	o x i d
oxy	o x y
ozon	o z o n
oà	oà
oài	oà i
oàm	oà m
oàn	oà n
oàng	oà ng
oành	oà nh
oác	oá c
oách	oá ch
oái	oá i
oán	oá n
oánh	oá nh
oáp	oá p
oát	oá t
oèo	oè o
oé	oé
oéc	oé c
oóc	oó c
oăm	oă m
oăn	oă n
oăng	oă ng
oạc	oạ c
oạcar	oạ c a r
oạch	oạ ch
oại	oạ i
oạp	oạ p
oải	oả i
oản	oả n
oắt	oắ t
oằn	oằ n
oẳn	oẳ n
oẳnc	oẳ n c
oẳng	oẳ ng
oặt	oặ t
oẹ	oẹ
oẻ	oẻ
pa	p a
pacifique	p a c i f i q u e
pagodon	p a g o d o n
pai	p a i
pain	p a i n
paix	p a i x
palan	p a l a n
palăng	p a l ă ng
pan	p a n
pang	p a ng
panh	p a nh
pao	p a o
parabol	p a r a b o l
pardessus	p a r d e s s u s
pari	p a r i
parreau	p a r r e a u
patanh	p a t a nh
patronne	p a tr o n n e
pauvres	p a u v r e s
pb	p b
pe	p e
pelits	p e l i t s
pemanganat	p e m a ng a n a t
pen	p e n
pendance	p e n d a n c e
pendu	p e n d u
peritxoa	p e r i t x oa
permanganat	p e r m a ng a n a t
pha	ph a
phai	ph a i
phan	ph a n
phang	ph a ng
phanh	ph a nh
phao	ph a o
phat xit	ph a t x i t
phau	ph a u
phay	ph a y
phe	ph e
phen	ph e n
pheo	ph e o
phi	ph i
phia	ph i a
phim	ph i m
phin	ph i n
phinh	ph i nh
phitippe	ph i t i p p e
phiu	ph i u
phiên	ph iê n
phiêu	ph iê u
phiếm	ph iế m
phiến	ph iế n
phiết	ph iế t
phiếu	ph iế u
phiền	ph iề n
phiện	ph iệ n
phiệt	ph iệ t
phiệu	ph iệ u
phlạo	ph l ạ o
pho	ph o
phoi	ph o i
phom	ph o m
phon	ph o n
phong	ph o ng
phosphorit	ph o sp h o r i t
photphat	ph o t ph a t
photpho	ph o t ph o
photphorit	ph o t ph o r i t
phoóc	ph oó c
phram	ph r a m
phrăng	ph r ă ng
phu	ph u
phua	ph u a
phui	ph u i
phula	ph u l a
phun	ph u n
phung	ph u ng
phuy	ph uy
phuốc	ph uố c
phà	ph à
phài	ph à i
phàm	ph à m
phàn	ph à n
phàng	ph à ng
phành	ph à nh
phào	ph à o
phá	ph á
phác	ph á c
phách	ph á ch
phái	ph á i
phán	ph á n
pháo	ph á o
pháp	ph á p
phát	ph á t
phân	ph â n
phây	ph â y
phè	ph è
phèn	ph è n
phèng	ph è ng
phèo	ph è o
phé	ph é
phéc	ph é c
phéng	ph é ng
phép	ph é p
phét	ph é t
phê	ph ê
phên	ph ê n
phênh	ph ê nh
phêu	ph ê u
phì	ph ì
phìa	ph ì a
phìn	ph ì n
phình	ph ì nh
phí	ph í
phía	ph í a
phích	ph í ch
phím	ph í m
phính	ph í nh
phít	ph í t
phò	ph ò
phòi	ph ò i
phòm	ph ò m
phòng	ph ò ng
phó	ph ó
phóc	ph ó c
phón	ph ó n
phóng	ph ó ng
phónng	ph ó n ng
phót	ph ó t
phô	ph ô
phôi	ph ô i
phôm	ph ô m
phôn	ph ô n
phông	ph ô ng
phôt	ph ô t
phù	ph ù
phùa	ph ù a
phùn	ph ù n
phùng	ph ù ng
phú	ph ú
phúc	ph ú c
phún	ph ú n
phúng	ph ú ng
phút	ph ú t
phăm	ph ă m
phăn	ph ă n
phăng	ph ă ng
phĩnh	ph ĩ nh
phũ	ph ũ
phơ	ph ơ
phơi	ph ơ i
phơn	ph ơ n
phưng	ph ư ng
phương	ph ươ ng
phước	ph ướ c
phướn	ph ướ n
phướng	ph ướ ng
phường	ph ườ ng
phưỡn	ph ưỡ n
phược	ph ượ c
phượng	ph ượ ng
phượu	ph ượ u
phạ	ph ạ
phạc	ph ạ c
phạch	ph ạ ch
phạm	ph ạ m
phạn	ph ạ n
phạng	ph ạ ng
phạo	ph ạ o
phạt	ph ạ t
phả	ph ả
phải	ph ả i
phản	ph ả n
phảng	ph ả ng
phảy	ph ả y
phấn	ph ấ n
phấp	ph ấ p
phất	ph ấ t
phầm	ph ầ m
phần	ph ầ n
phẩm	ph ẩ m
phẩn	ph ẩ n
phẩy	ph ẩ y
phẫn	ph ẫ n
phẫu	ph ẫ u
phận	ph ậ n
phập	ph ậ p
phật	ph ậ t
phắc	ph ắ c
phắn	ph ắ n
phắp	ph ắ p
phắt	ph ắ t
phẳng	ph ẳ ng
phẹc	ph ẹ c
phẹt	ph ẹ t
phế	ph ế
phếch	ph ế ch
phết	ph ế t
phề	ph ề
phềnh	ph ề nh
phều	ph ề u
phễn	ph ễ n
phễu	ph ễ u
phệ	ph ệ
phệnh	ph ệ nh
phệt	ph ệ t
phệu	ph ệ u
phỉ	ph ỉ
phỉnh	ph ỉ nh
phị	ph ị
phịa	ph ị a
phịch	ph ị ch
phịt	ph ị t
phịu	ph ị u
phọc	ph ọ c
phọng	ph ọ ng
phọp	ph ọ p
phọt	ph ọ t
phỏng	ph ỏ ng
phố	ph ố
phốc	ph ố c
phối	ph ố i
phốp	ph ố p
phốt	ph ố t
phồ	ph ồ
phồm	ph ồ m
phồn	ph ồ n
phồng	ph ồ ng
phổ	ph ổ
phổi	ph ổ i
phổng	ph ổ ng
phỗng	ph ỗ ng
phộng	ph ộ ng
phớ	ph ớ
phới	ph ớ i
phớn	ph ớ n
phớt	ph ớ t
phờ	ph ờ
phở	ph ở
phởn	ph ở n
phỡn	ph ỡ n
phụ	ph ụ
phục	ph ụ c
phụng	ph ụ ng
phụp	ph ụ p
phụt	ph ụ t
phủ	ph ủ
phủi	ph ủ i
phủng	ph ủ ng
phứa	ph ứ a
phức	ph ứ c
phứt	ph ứ t
phừn	ph ừ n
phừng	ph ừ ng
phựa	ph ự a
phực	ph ự c
phựt	ph ự t
pi	p i
pijama	p i a m a
pin	p i n
ping	p i ng
pinh	p i nh
pirit	p i r i t
piêu	p iê u
plaisir	p l a i s i r
plaisirs	p l a i s i r s
platin	p l a t i n
pli	p l i
plát	p l á t
plây	p l â y
plăng	p l ă ng
po	p o
poa	p oa
poids	p o i d s
polietylen	p o l i e t y l e n
polime	p o l i m e
polivitamin	p o l i v i t a m i n
polyvitamin	p o l y v i t a m i n
pom	p o m
pommes	p o m m e s
ponchon	p o n ch o n
pong	p o ng
pop	p o p
populaire	p o p u l a i r e
postaux	p o s t a u x
posteriori	p o s t e r i o r i
pourquoi	p o u r q u o i
poussa	p o u s s a
poọng	p oọ ng
prabahol	p r a b a h o l
prao	p r a o
preh	p r e h
printanier	p r i n t a n i e r
priori	p r i o r i
projadophick	p r o a d o ph i c k
prostiuée	p r o s t i u é e
prostiuées	p r o s t i u é e s
protid	p r o t i d
prâng	p r â ng
présente	p r é s e n t e
prévost	p r é v o s t
prông	p r ô ng
pt	p t
pts	p t s
ptt	p t t
pu	p u
pua	p u a
pudeur	p u d e u r
pui	p u i
pula	p u l a
puli	p u l i
pun	p u n
puy	p uy
puốc	p uố c
puộc	p uộ c
pyjama	p y a m a
pyrit	p y r i t
pà	p à
pài	p à i
pàng	p à ng
pác	p á c
pán	p á n
páp	p á p
pát	p á t
pâles	p â l e s
pâu	p â u
père	p è r e
péc	p é c
pédérastre	p é d é r a s tr e
pégasec	p é g a s e c
péo	p é o
pét	p é t
pê	p ê
pí	p í
píc	p í c
pích	p í ch
píp	p í p
pít	p í t
pô	p ô
pông	p ô ng
pôông	p ô ô ng
păh	p ă h
păng	p ă ng
pơ	p ơ
pơluya	p ơ l uy a
pơng	p ơ ng
pươi	p ươ i
pạ	p ạ
pả	p ả
pảo	p ả o
pấc	p ấ c
pắc	p ắ c
pằn	p ằ n
pẹc	p ẹ c
pẻ	p ẻ
pế	p ế
pếch	p ế ch
pết	p ế t
pốt	p ố t
pờ	p ờ
pụa	p ụ a
qs	q s
qua	q u a
quai	q u a i
quan	q u a n
quang	q u a ng
quanh	q u a nh
quao	q u a o
quau	q u a u
quavez	q u a v e z
quay	q u a y
que	q u e
quedel	q u e d e l
quelques	q u e l q u e s
quen	q u e n
queng	q u e ng
queo	q u e o
quetzal	q u e t z a l
qui	q u i
quinacrine	q u i n a c r i n e
quoàng	q u oà ng
quoạng	q u oạ ng
quoắt	q u oắ t
quuyết	q u uyế t
quy	q uy
quyên	q uyê n
quyến	q uyế n
quyết	q uyế t
quyền	q uyề n
quyển	q uyể n
quyện	q uyệ n
quyệt	q uyệ t
quà	q u à
quài	q u à i
quàn	q u à n
quàng	q u à ng
quành	q u à nh
quào	q u à o
quàu	q u à u
quày	q u à y
quá	q u á
quác	q u á c
quách	q u á ch
quái	q u á i
quán	q u á n
quáng	q u á ng
quánh	q u á nh
quáo	q u á o
quát	q u á t
quáu	q u á u
quáy	q u á y
quân	q uâ n
quây	q uâ y
quãng	q u ã ng
què	q u è
quèn	q u è n
quèo	q u è o
qué	q u é
quéc	q u é c
quén	q u é n
quéo	q u é o
quét	q u é t
quê	q uê
quên	q uê n
quì	q u ì
quình	q u ì nh
quí	q u í
quích	q u í ch
quít	q u í t
quý	q uý
quých	q uý ch
quýnh	q uý nh
quýt	q uý t
quýu	q uý u
quăm	q u ă m
quăn	q u ă n
quăng	q u ă ng
quĩ	q u ĩ
quơ	q uơ
quạ	q u ạ
quạc	q u ạ c
quạch	q u ạ ch
quại	q u ạ i
quạng	q u ạ ng
quạnh	q u ạ nh
quạt	q u ạ t
quạu	q u ạ u
quạy	q u ạ y
quả	q u ả
quải	q u ả i
quản	q u ả n
quảng	q u ả ng
quảy	q u ả y
quấc	q uấ c
quấn	q uấ n
quất	q uấ t
quấy	q uấ y
quần	q uầ n
quầng	q uầ ng
quầy	q uầ y
quẩn	q uẩ n
quẩng	q uẩ ng
quẩy	q uẩ y
quẫn	q uẫ n
quẫy	q uẫ y
quận	q uậ n
quật	q uậ t
quậy	q uậ y
quắc	q u ắ c
quắm	q u ắ m
quắn	q u ắ n
quắp	q u ắ p
quắt	q u ắ t
quằm	q u ằ m
quằn	q u ằ n
quẳm	q u ẳ m
quẳng	q u ẳ ng
quặc	q u ặ c
quặm	q u ặ m
quặn	q u ặ n
quặng	q u ặ ng
quặp	q u ặ p
quặt	q u ặ t
quẹn	q u ẹ n
quẹo	q u ẹ o
quẹt	q u ẹ t
quẻ	q u ẻ
quẽ	q u ẽ
quế	q uế
quếch	q uế ch
quến	q uế n
quếnh	q uế nh
quết	q uế t
quếu	q uế u
quề	q uề
quềnh	q uề nh
quều	q uề u
quệ	q uệ
quệch	q uệ ch
quện	q uệ n
quệnh	q uệ nh
quệt	q uệ t
quỉ	q u ỉ
quị	q u ị
quịt	q u ị t
quọ	q u ọ
quốc	q uố c
quớ	q uớ
quới	q uớ i
quớt	q uớ t
quờ	q uờ
quờn	q uờ n
quở	q uở
quỳ	q uỳ
quỳnh	q uỳ nh
quỵ	q uỵ
quỵp	q uỵ p
quỵt	q uỵ t
quỷ	q uỷ
quỷnh	q uỷ nh
quỹ	q uỹ
qùy	q ù y
qúy	q ú y
qũy	q ũ y
qụy	q ụ y
qủy	q ủ y
ra	r a
radian	r a d i a n
rai	r a i
ralum	r a l u m
ram	r a m
ran	r a n
rang	r a ng
ranh	r a nh
rao	r a o
rap	r a p
rat	r a t
rau	r a u
ray	r a y
rađa	r a đ a
rađian	r a đ i a n
rađium	r a đ i u m
rcăm	r c ă m
re	r e
rem	r e m
ren	r e n
renan	r e n a n
rend	r e n d
reng	r e ng
reo	r e o
resie	r e s i e
reve	r e v e
rhum	r h u m
ri	r i
ria	r i a
ric	r i c
richepin	r i ch e p i n
rim	r i m
rin	r i n
ring	r i ng
rinh	r i nh
rire	r i r e
rit	r i t
riu	r i u
rivière	r i v i è r e
riyal	r i y a l
rià	r i à
riên	r iê n
riêng	r iê ng
riêu	r iê u
riếp	r iế p
riết	r iế t
riếu	r iế u
riềm	r iề m
riềng	r iề ng
riễu	r iễ u
riệt	r iệ t
rlâm	r l â m
ro	r o
roa	r oa
robespicrre	r o b e sp i c r r e
robespierre	r o b e sp i e r r e
robinạon	r o b i n ạ o n
roentgen	r oe n t g e n
roi	r o i
rollandes	r o l l a n d e s
rom	r o m
rompt	r o m p t
ron	r o n
rondo	r o n d o
roneo	r o n e o
rong	r o ng
rontgen	r o n t g e n
rooi	r oo i
rostand	r o s t a n d
roubaud	r o u b a u d
roussecau	r o u s s e c a u
roàng	r oà ng
roá	r oá
roòng	r oò ng
roại	r oạ i
roạt	r oạ t
rra	r r a
rrrít	r r r í t
ru	r u
rua	r u a
rufiyaa	r u f i y a a
rui	r u i
rum	r u m
rumba	r u m b a
run	r u n
rung	r u ng
ruy	r uy
ruê	r uê
ruôn	r uô n
ruýp	r uý p
ruốc	r uố c
ruối	r uố i
ruốt	r uố t
ruồi	r uồ i
ruồng	r uồ ng
ruổi	r uổ i
ruỗi	r uỗ i
ruỗng	r uỗ ng
ruộc	r uộ c
ruộm	r uộ m
ruộng	r uộ ng
ruột	r uộ t
rà	r à
rài	r à i
ràn	r à n
ràng	r à ng
rành	r à nh
rào	r à o
rày	r à y
rá	r á
rác	r á c
rách	r á ch
rái	r á i
rám	r á m
rán	r á n
ráng	r á ng
ráo	r á o
ráp	r á p
rát	r á t
ráu	r á u
ráy	r á y
râm	r â m
rân	r â n
râu	r â u
rây	r â y
rã	r ã
rãi	r ã i
rãnh	r ã nh
rão	r ã o
rãy	r ã y
rè	r è
rèm	r è m
rèn	r è n
rèo	r è o
ré	r é
rén	r é n
réo	r é o
républiique	r é p u b l i i q u e
rét	r é t
rê	r ê
rêm	r ê m
rên	r ê n
rêu	r ê u
rì	r ì
rìa	r ì a
rình	r ì nh
rìu	r ì u
rí	r í
rích	r í ch
rím	r í m
ríp	r í p
rít	r í t
ríu	r í u
rò	r ò
ròi	r ò i
ròm	r ò m
ròn	r ò n
ròng	r ò ng
ró	r ó
róc	r ó c
rói	r ó i
róm	r ó m
rón	r ó n
róng	r ó ng
rót	r ó t
rô	r ô
rôcket	r ô c k e t
rôm	r ô m
rôn	r ô n
rông	r ô ng
rôti	r ô t i
rôties	r ô t i e s
rõ	r õ
rõi	r õ i
rù	r ù
rùa	r ù a
rùm	r ù m
rùn	r ù n
rùng	r ù ng
rú	r ú
rúc	r ú c
rúi	r ú i
rúm	r ú m
rún	r ú n
rúng	r ú ng
rúp	r ú p
rút	r ú t
răm	r ă m
răn	r ă n
răng	r ă ng
rĩ	r ĩ
rĩn	r ĩ n
rũ	r ũ
rũa	r ũ a
rơ	r ơ
rơi	r ơ i
rơle	r ơ l e
rơm	r ơ m
rơmooc	r ơ m oo c
rơn	r ơ n
rơnghen	r ơ ngh e n
rư	r ư
rưa	r ư a
rưng	r ư ng
rươi	r ươ i
rươm	r ươ m
rương	r ươ ng
rước	r ướ c
rưới	r ướ i
rướm	r ướ m
rướn	r ướ n
rười	r ườ i
rườm	r ườ m
rườn	r ườ n
rường	r ườ ng
rưởi	r ưở i
rưỡi	r ưỡ i
rượi	r ượ i
rượn	r ượ n
rượng	r ượ ng
rượt	r ượ t
rượu	r ượ u
rạ	r ạ
rạc	r ạ c
rạch	r ạ ch
rạm	r ạ m
rạn	r ạ n
rạng	r ạ ng
rạo	r ạ o
rạp	r ạ p
rạt	r ạ t
rạy	r ạ y
rả	r ả
rải	r ả i
rảng	r ả ng
rảnh	r ả nh
rảo	r ả o
rảu	r ả u
rảy	r ả y
rấm	r ấ m
rấn	r ấ n
rấp	r ấ p
rất	r ấ t
rầm	r ầ m
rần	r ầ n
rầu	r ầ u
rầy	r ầ y
rẩm	r ẩ m
rẩy	r ẩ y
rẫm	r ẫ m
rẫy	r ẫ y
rậm	r ậ m
rận	r ậ n
rập	r ậ p
rật	r ậ t
rậu	r ậ u
rậy	r ậ y
rắc	r ắ c
rắm	r ắ m
rắn	r ắ n
rắp	r ắ p
rắt	r ắ t
rằm	r ằ m
rằn	r ằ n
rằng	r ằ ng
rặc	r ặ c
rặm	r ặ m
rặn	r ặ n
rặng	r ặ ng
rặt	r ặ t
rẹo	r ẹ o
rẹt	r ẹ t
rẻ	r ẻ
rẻng	r ẻ ng
rẻo	r ẻ o
rẽ	r ẽ
rế	r ế
rếch	r ế ch
rến	r ế n
rếp	r ế p
rết	r ế t
rếu	r ế u
rề	r ề
rền	r ề n
rềnh	r ề nh
rều	r ề u
rể	r ể
rểnh	r ể nh
rễ	r ễ
rệ	r ệ
rệch	r ệ ch
rện	r ệ n
rệp	r ệ p
rệt	r ệ t
rệu	r ệ u
rỉ	r ỉ
rỉa	r ỉ a
rỉn	r ỉ n
rỉnh	r ỉ nh
rị	r ị
rịa	r ị a
rịch	r ị ch
rịn	r ị n
rịp	r ị p
rịt	r ị t
rọ	r ọ
rọc	r ọ c
rọi	r ọ i
rọm	r ọ m
rọn	r ọ n
rọt	r ọ t
rỏ	r ỏ
rỏi	r ỏ i
rỏm	r ỏ m
rỏn	r ỏ n
rỏng	r ỏ ng
rốc	r ố c
rối	r ố i
rốn	r ố n
rống	r ố ng
rốp	r ố p
rốt	r ố t
rồ	r ồ
rồi	r ồ i
rồm	r ồ m
rồn	r ồ n
rồng	r ồ ng
rổ	r ổ
rổi	r ổ i
rổn	r ổ n
rổng	r ổ ng
rỗ	r ỗ
rỗi	r ỗ i
rỗng	r ỗ ng
rộ	r ộ
rộc	r ộ c
rộm	r ộ m
rộn	r ộ n
rộng	r ộ ng
rộp	r ộ p
rột	r ộ t
rớ	r ớ
rớm	r ớ m
rớp	r ớ p
rớt	r ớ t
rờ	r ờ
rời	r ờ i
rờm	r ờ m
rờn	r ờ n
rở	r ở
rởm	r ở m
rởn	r ở n
rỡ	r ỡ
rỡm	r ỡ m
rỡn	r ỡ n
rợ	r ợ
rợi	r ợ i
rợm	r ợ m
rợn	r ợ n
rợp	r ợ p
rợt	r ợ t
rụ	r ụ
rụa	r ụ a
rục	r ụ c
rụi	r ụ i
rụm	r ụ m
rụng	r ụ ng
rụp	r ụ p
rụt	r ụ t
rủ	r ủ
rủa	r ủ a
rủi	r ủ i
rủn	r ủ n
rủng	r ủ ng
rứa	r ứ a
rức	r ứ c
rứt	r ứ t
rừ	r ừ
rừng	r ừ ng
rửa	r ử a
rửng	r ử ng
rữa	r ữ a
rựa	r ự a
rực	r ự c
rựng	r ự ng
rỵn	r ỵ n
sa	s a
sacarin	s a c a r i n
sacarosa	s a c a r o s a
saccharose	s a c ch a r o s e
sai	s a i
sam	s a m
samovar	s a m o v a r
san	s a n
sang	s a ng
sanh	s a nh
santonin	s a n t o n i n
sao	s a o
sapristi	s a p r i s t i
sarraut	s a r r a u t
sau	s a u
say	s a y
sb	s b
scillier	s c i l l i e r
sco	s c o
se	s e
sen	s e n
seo	s e o
septembre	s e p t e m b r e
serenata	s e r e n a t a
servantes	s e r v a n t e s
seuls	s e u l s
seulsz	s e u l s z
sexuelle	s e x u e l l e
si	s i
sia	s i a
sic	s i c
sida	s i d a
silic	sil i c
silicat	sil i c a t
sim	s i m
simpozium	s i m p o z i u m
sin	s i n
sinh	s i nh
sinhala	s i nh a l a
sion	s i o n
siu	s i u
siêng	s iê ng
siêu	s iê u
siếc	s iế c
siết	s iế t
siết1	s iế t
siếu	s iế u
siểm	s iể m
siểng	s iể ng
siễn	s iễ n
siệng	s iệ ng
slìn	s l ì n
sm	s m
sma	s m a
smach	s m a ch
sn	s n
snách	s n á ch
so	s o
soa	s oa
sodome	s o d o m e
soi	s o i
soit	s o i t
solenoid	s o l e n o i d
som	s o m
son	s o n
song	s o ng
soong	s oo ng
soufflees	s o u f f l e e s
souffles	s o u f f l e s
souffre	s o u f f r e
soum	s o u m
souvent	s o u v e n t
soà	s oà
soài	s oà i
soàm	s oà m
soàn	s oà n
soái	s oá i
soán	s oá n
soát	s oá t
soóc	s oó c
soăn	s oă n
soạn	s oạ n
soạng	s oạ ng
soạp	s oạ p
soạt	s oạ t
soải	s oả i
soảng	s oả ng
soẹt	s oẹ t
spe	sp e
spi	sp i
st	s t
stacte	s t a c t e
staline	s t a l i n e
stato	s t a t o
ste	s t e
streptomycin	s tr e p t o m y c i n
strychnin	s tr y ch n i n
strích	s tr í ch
stác	s t á c
su	s u
sua	s u a
suc	s u c
sui	s u i
suis	s u i s
sulfamid	s u l f a m i d
sulfat	s u l f a t
sum	s u m
sun	s u n
sunfamit	s u n f a m i t
sunfat	s u n f a t
sunfua	s u n f u a
sunfuric	s u n f u r i c
sung	s u ng
sup	s u p
supde	s u p d e
superflu	s u p e r f l u
surtout	s u r t o u t
suy	s uy
suyển	s uyể n
suyễn	s uyễ n
suê	s uê
suôn	s uô n
suông	s uô ng
suý	s uý
suýt	s uý t
suất	s uấ t
suối	s uố i
suốt	s uố t
suồng	s uồ ng
suỵt	s uỵ t
symphonie	s y m ph o n i e
syndicat	s y n d i c a t
sà	s à
sài	s à i
sài goòng	s à i g oò ng
sàigoòng	s à i g oò ng
sàm	s à m
sàn	s à n
sàng	s à ng
sành	s à nh
sào	s à o
sá	s á
sác	s á c
sách	s á ch
sái	s á i
sám	s á m
sán	s á n
sáng	s á ng
sánh	s á nh
sáo	s á o
sáp	s á p
sát	s á t
sáu	s á u
sâm	s â m
sâm banh	s â m b a nh
sân	s â n
sâng	s â ng
sâu	s â u
sây	s â y
sã	s ã
sãi	s ã i
sè	s è
sèo	s è o
séc	s é c
sém	s é m
séo	s é o
sép	s é p
sét	s é t
sê	s ê
sên	s ê n
sênh	s ê nh
sêu	s ê u
sì	s ì
sìi	s ì i
sìn	s ì n
sình	s ì nh
sí	s í
síc	s í c
sích	s í ch
sín	s í n
sính	s í nh
sít	s í t
sò	s ò
sòa	s òa
sòi	s ò i
sòm	s ò m
sòn	s ò n
sòng	s ò ng
sóc	s ó c
sói	s ó i
sóm	s ó m
són	s ó n
sóng	s ó ng
sóoc	s ó o c
sót	s ó t
sô	s ô
sôcôla	s ô c ô l a
sôi	s ô i
sông	s ô ng
sôvanh	s ô v a nh
sõi	s õ i
sõng	s õ ng
sù	s ù
sùi	s ù i
sùm	s ù m
sùng	s ù ng
sú	s ú
súc	s ú c
sún	s ú n
súng	s ú ng
súp	s ú p
sút	s ú t
súy	s ú y
săm	s ă m
săn	s ă n
săng	s ă ng
săngta	s ă ng t a
săảm	s ă ả m
sĩ	s ĩ
sũng	s ũ ng
sơ	s ơ
sơm	s ơ m
sơmi	s ơ m i
sơn	s ơ n
sư	s ư
sưa	s ư a
sưng	s ư ng
sưu	s ư u
sươi	s ươ i
sương	s ươ ng
sướng	s ướ ng
sướt	s ướ t
sườn	s ườ n
sường	s ườ ng
sưởi	s ưở i
sượng	s ượ ng
sượt	s ượ t
sạ	s ạ
sạc	s ạ c
sạch	s ạ ch
sại	s ạ i
sạm	s ạ m
sạn	s ạ n
sạo	s ạ o
sạp	s ạ p
sạt	s ạ t
sả	s ả
sải	s ả i
sản	s ả n
sảng	s ả ng
sảnh	s ả nh
sảo	s ả o
sảy	s ả y
sấm	s ấ m
sấn	s ấ n
sấp	s ấ p
sất	s ấ t
sấu	s ấ u
sấy	s ấ y
sầm	s ầ m
sần	s ầ n
sầu	s ầ u
sầy	s ầ y
sẩm	s ẩ m
sẩn	s ẩ n
sẩy	s ẩ y
sẫm	s ẫ m
sậm	s ậ m
sập	s ậ p
sật	s ậ t
sậu	s ậ u
sậy	s ậ y
sắc	s ắ c
sắm	s ắ m
sắn	s ắ n
sắng	s ắ ng
sắp	s ắ p
sắt	s ắ t
sằng	s ằ ng
sẳc	s ẳ c
sẵn	s ẵ n
sẵng	s ẵ ng
sẵp	s ẵ p
sặc	s ặ c
sặm	s ặ m
sặt	s ặ t
sẹ	s ẹ
sẹm	s ẹ m
sẹo	s ẹ o
sẹp	s ẹ p
sẹt	s ẹ t
sẻ	s ẻ
sẻn	s ẻ n
sẽ	s ẽ
sếch	s ế ch
sến	s ế n
sếp	s ế p
sết	s ế t
sếu	s ế u
sề	s ề
sền	s ề n
sềnh	s ề nh
sều	s ề u
sể	s ể
sểnh	s ể nh
sễ	s ễ
sệ	s ệ
sệch	s ệ ch
sệp	s ệ p
sệt	s ệ t
sỉ	s ỉ
sỉa	s ỉ a
sỉnh	s ỉ nh
sị	s ị
sịa	s ị a
sịch	s ị ch
sịt	s ị t
sọ	s ọ
sọc	s ọ c
sọm	s ọ m
sọt	s ọ t
sỏ	s ỏ
sỏi	s ỏ i
số	s ố
sốc	s ố c
sống	s ố ng
sốp	s ố p
sốt	s ố t
sồ	s ồ
sồi	s ồ i
sồn	s ồ n
sồng	s ồ ng
sổ	s ổ
sổi	s ổ i
sổng	s ổ ng
sỗ	s ỗ
sộ	s ộ
sộc	s ộ c
sộp	s ộ p
sột	s ộ t
sớ	s ớ
sới	s ớ i
sớm	s ớ m
sớn	s ớ n
sớt	s ớ t
sờ	s ờ
sờm	s ờ m
sờn	s ờ n
sở	s ở
sởi	s ở i
sởn	s ở n
sỡ	s ỡ
sợ	s ợ
sợi	s ợ i
sụ	s ụ
sụa	s ụ a
sục	s ụ c
sụm	s ụ m
sụn	s ụ n
sụp	s ụ p
sụt	s ụ t
sủ	s ủ
sủa	s ủ a
sủi	s ủ i
sủng	s ủ ng
sứ	s ứ
sứa	s ứ a
sức	s ứ c
sứt	s ứ t
sừ	s ừ
sừn	s ừ n
sừng	s ừ ng
sử	s ử
sửa	s ử a
sửng	s ử ng
sửu	s ử u
sữa	s ữ a
sững	s ữ ng
sự	s ự
sự thực	s ự th ự c
sực	s ự c
sựng	s ự ng
sựt	s ự t
sựthực	s ự th ự c
sỹ	s ỹ
ta	t a
tabu	t a b u
tai	t a i
taiga	t a i g a
taka	t a k a
tala	t a l a
tam	t a m
tan	t a n
tananh	t a n a nh
tand	t a n d
tang	t a ng
tanh	t a nh
tannin	t a n n i n
tao	t a o
tareh	t a r e h
tatăng	t a t ă ng
tau	t a u
tay	t a y
tb	t b
tbuăn	t b u ă n
tdtt	t d t t
te	t e
tem	t e m
ten	t e n
teng	t e ng
tenge	t e ng e
teo	t e o
tetanos	t e t a n o s
tetracycline	t e tr a c y c l i n e
tha	th a
thai	th a i
tham	th a m
than	th a n
thang	th a ng
thanh	th a nh
thao	th a o
thau	th a u
thay	th a y
the	th e
then	th e n
theo	th e o
thermidor	th e r m i d o r
thi	th i
thia	th i a
thin	th i n
thinh	th i nh
thiu	th i u
thiêm	th iê m
thiên	th iê n
thiêng	th iê ng
thiêu	th iê u
thiếc	th iế c
thiến	th iế n
thiếp	th iế p
thiết	th iế t
thiếu	th iế u
thiềm	th iề m
thiền	th iề n
thiềng	th iề ng
thiều	th iề u
thiểm	th iể m
thiển	th iể n
thiểu	th iể u
thiện	th iệ n
thiệp	th iệ p
thiệt	th iệ t
thiệu	th iệ u
tho	th o
thoa	th oa
thoai	th oa i
thoang	th oa ng
thoi	th o i
thom	th o m
thon	th o n
thong	th o ng
thoà	th oà
thoàn	th oà n
thoá	th oá
thoái	th oá i
thoán	th oá n
thoáng	th oá ng
thoát	th oá t
thoã	th oã
thoòng	th oò ng
thoăn	th oă n
thoại	th oạ i
thoạt	th oạ t
thoả	th oả
thoải	th oả i
thoảng	th oả ng
thoắng	th oắ ng
thoắt	th oắ t
thu	th u
thua	th u a
thui	th u i
thum	th u m
thun	th u n
thung	th u ng
thuyên	th uyê n
thuyến	th uyế n
thuyết	th uyế t
thuyền	th uyề n
thuê	th uê
thuôn	th uô n
thuông	th uô ng
thuý	th uý
thuơng	th uơ ng
thuấn	th uấ n
thuần	th uầ n
thuẫn	th uẫ n
thuận	th uậ n
thuật	th uậ t
thuế	th uế
thuể	th uể
thuốc	th uố c
thuốn	th uố n
thuồi	th uồ i
thuồn	th uồ n
thuồng	th uồ ng
thuổc	th uổ c
thuổng	th uổ ng
thuỗn	th uỗ n
thuộc	th uộ c
thuội	th uộ i
thuộm	th uộ m
thuột	th uộ t
thuở	th uở
thuỳ	th uỳ
thuỵ	th uỵ
thuỷ	th uỷ
thà	th à
thài	th à i
thàm	th à m
thàng	th à ng
thành	th à nh
thào	th à o
thày	th à y
thá	th á
thác	th á c
thách	th á ch
thái	th á i
thám	th á m
thán	th á n
tháng	th á ng
thánh	th á nh
tháo	th á o
tháp	th á p
thát	th á t
tháu	th á u
tháy	th á y
thâm	th â m
thân	th â n
thâu	th â u
thây	th â y
thãi	th ã i
thè	th è
thèm	th è m
thèn	th è n
thèo	th è o
thé	th é
thép	th é p
thét	th é t
thê	th ê
thêm	th ê m
thênh	th ê nh
thêta	th ê t a
thêu	th ê u
thì	th ì
thìa	th ì a
thìn	th ì n
thình	th ì nh
thìu	th ì u
thí	th í
thía	th í a
thích	th í ch
thím	th í m
thín	th í n
thính	th í nh
thíp	th í p
thít	th í t
thò	th ò
thòa	th òa
thòi	th ò i
thòm	th ò m
thòng	th ò ng
thó	th ó
thóa	th óa
thóc	th ó c
thói	th ó i
thóm	th ó m
thóp	th ó p
thót	th ó t
thô	th ô
thôi	th ô i
thôn	th ô n
thông	th ô ng
thõa	th õ a
thõm	th õ m
thõng	th õ ng
thù	th ù
thùa	th ù a
thùi	th ù i
thùm	th ù m
thùn	th ù n
thùng	th ù ng
thùy	th ù y
thú	th ú
thúc	th ú c
thúi	th ú i
thúng	th ú ng
thút	th ú t
thúy	th ú y
thăm	th ă m
thăn	th ă n
thăng	th ă ng
thĩ	th ĩ
thũng	th ũ ng
thơ	th ơ
thơi	th ơ i
thơm	th ơ m
thơn	th ơ n
thư	th ư
thưa	th ư a
thưng	th ư ng
thương	th ươ ng
thước	th ướ c
thướng	th ướ ng
thướt	th ướ t
thười	th ườ i
thườn	th ườ n
thường	th ườ ng
thưởng	th ưở ng
thưỡi	th ưỡ i
thưỡn	th ưỡ n
thược	th ượ c
thượng	th ượ ng
thượt	th ượ t
thạc	th ạ c
thạch	th ạ ch
thạnh	th ạ nh
thạo	th ạ o
thạp	th ạ p
thả	th ả
thải	th ả i
thảm	th ả m
thản	th ả n
thảng	th ả ng
thảnh	th ả nh
thảo	th ả o
thảy	th ả y
thấm	th ấ m
thấp	th ấ p
thất	th ấ t
thấu	th ấ u
thấy	th ấ y
thầm	th ầ m
thầm’	th ầ m
thần	th ầ n
thầu	th ầ u
thầy	th ầ y
thẩm	th ẩ m
thẩn	th ẩ n
thẩu	th ẩ u
thẩy	th ẩ y
thẫm	th ẫ m
thẫn	th ẫ n
thậm	th ậ m
thận	th ậ n
thập	th ậ p
thật	th ậ t
thắc	th ắ c
thắm	th ắ m
thắn	th ắ n
thắng	th ắ ng
thắp	th ắ p
thắt	th ắ t
thằn	th ằ n
thằng	th ằ ng
thẳm	th ẳ m
thẳng	th ẳ ng
thặng	th ặ ng
thẹn	th ẹ n
thẹo	th ẹ o
thẹp	th ẹ p
thẻ	th ẻ
thẻn	th ẻ n
thẻo	th ẻ o
thẽ	th ẽ
thế	th ế
thếch	th ế ch
thếp	th ế p
thết	th ế t
thề	th ề
thềm	th ề m
thều	th ề u
thể	th ể
thểu	th ể u
thệ	th ệ
thện	th ệ n
thỉ	th ỉ
thỉnh	th ỉ nh
thỉu	th ỉ u
thị	th ị
thịch	th ị ch
thịnh	th ị nh
thịt	th ị t
thịu	th ị u
thọ	th ọ
thọc	th ọ c
thọt	th ọ t
thỏ	th ỏ
thỏa	th ỏa
thỏang	th ỏa ng
thỏi	th ỏ i
thỏm	th ỏ m
thỏng	th ỏ ng
thố	th ố
thốc	th ố c
thối	th ố i
thốn	th ố n
thống	th ố ng
thốt	th ố t
thồ	th ồ
thồi	th ồ i
thồm	th ồ m
thồn	th ồ n
thổ	th ổ
thổi	th ổ i
thổn	th ổ n
thỗn	th ỗ n
thộc	th ộ c
thộn	th ộ n
thộp	th ộ p
thột	th ộ t
thớ	th ớ
thới	th ớ i
thớm	th ớ m
thớt	th ớ t
thờ	th ờ
thời	th ờ i
thờm	th ờ m
thờn	th ờ n
thở	th ở
thợ	th ợ
thợt	th ợ t
thụ	th ụ
thục	th ụ c
thụi	th ụ i
thụng	th ụ ng
thụp	th ụ p
thụt	th ụ t
thụy	th ụ y
thủ	th ủ
thủa	th ủ a
thủi	th ủ i
thủm	th ủ m
thủng	th ủ ng
thủy	th ủ y
thứ	th ứ
thức	th ứ c
thừ	th ừ
thừa	th ừ a
thừng	th ừ ng
thử	th ử
thửa	th ử a
thửng	th ử ng
thững	th ữ ng
thự	th ự
thực	th ự c
ti	t i
tia	t i a
tic	t i c
tiens	t i e n s
tige	t i g e
tigôn	t i g ô n
tim	t i m
tin	t i n
ting	t i ng
tinh	t i nh
tions	t i o n s
tit	t i t
tiu	t i u
tivi	t i v i
tiêm	t iê m
tiên	t iê n
tiêng	t iê ng
tiêu	t iê u
tiẻn	t i ẻ n
tiếc	t iế c
tiếm	t iế m
tiến	t iế n
tiếng	t iế ng
tiếp	t iế p
tiết	t iế t
tiếu	t iế u
tiềm	t iề m
tiền	t iề n
tiềng	t iề ng
tiều	t iề u
tiểu	t iể u
tiễn	t iễ n
tiễu	t iễ u
tiệc	t iệ c
tiệm	t iệ m
tiện	t iệ n
tiệp	t iệ p
tiệt	t iệ t
tl	t l
tlát	t l á t
to	t o
toa	t oa
toan	t oa n
toang	t oa ng
toanh	t oa nh
toe	t oe
toen	t oe n
toi	t o i
tom	t o m
ton	t o n
tong	t o ng
tontaine	t o n t a i n e
toong	t oo ng
top	t o p
topo	t o p o
torng	t o r ng
toujours	t o u o u r s
toulouạe	t o u l o u ạ e
tourane	t o u r a n e
tous	t o u s
toà	t oà
toài	t oà i
toàn	t oà n
toàng	t oà ng
toá	t oá
toác	t oá c
toái	t oá i
toán	t oá n
toáng	t oá ng
toát	t oá t
toáy	t oá y
toè	t oè
toèn	t oè n
toé	t oé
toét	t oé t
toòng	t oò ng
toóc	t oó c
toạ	t oạ
toạc	t oạ c
toại	t oạ i
toạng	t oạ ng
toả	t oả
toản	t oả n
toẹt	t oẹ t
toẻ	t oẻ
toẽ	t oẽ
tp	t p
tra	tr a
tracom	tr a c o m
trai	tr a i
tram	tr a m
tran	tr a n
trang	tr a ng
tranh	tr a nh
trao	tr a o
trat	tr a t
trau	tr a u
tre	tr e
treng	tr e ng
treo	tr e o
tri	tr i
trinh	tr i nh
triod	tr i o d
triêng	tr iê ng
triêu	tr iê u
triến	tr iế n
triết	tr iế t
triền	tr iề n
triềng	tr iề ng
triều	tr iề u
triển	tr iể n
triện	tr iệ n
triệng	tr iệ ng
triệt	tr iệ t
triệu	tr iệ u
tro	tr o
troi	tr o i
trom	tr o m
trompet	tr o m p e t
tron	tr o n
trong	tr o ng
trop	tr o p
troẹt	tr oẹ t
tru	tr u
trui	tr u i
trun	tr u n
trung	tr u ng
truy	tr uy
truyền	tr uyề n
truyện	tr uyệ n
truân	tr uâ n
truông	tr uô ng
truất	tr uấ t
truật	tr uậ t
truồi	tr uồ i
truồng	tr uồ ng
truột	tr uộ t
truỵ	tr uỵ
trà	tr à
trài	tr à i
tràm	tr à m
tràn	tr à n
tràng	tr à ng
trành	tr à nh
trào	tr à o
tràu	tr à u
trày	tr à y
trá	tr á
trác	tr á c
trách	tr á ch
trái	tr á i
trám	tr á m
trán	tr á n
tráng	tr á ng
tránh	tr á nh
tráo	tr á o
tráp	tr á p
trát	tr á t
trâm	tr â m
trân	tr â n
trâng	tr â ng
trâu	tr â u
trây	tr â y
trã	tr ã
trãi	tr ã i
trè	tr è
trèm	tr è m
trèn	tr è n
trèo	tr è o
très	tr è s
tréc	tr é c
trém	tr é m
tréo	tr é o
trét	tr é t
trê	tr ê
trên	tr ê n
trêu	tr ê u
trì	tr ì
trình	tr ì nh
trìu	tr ì u
trí	tr í
tría	tr í a
trích	tr í ch
trính	tr í nh
trít	tr í t
tríu	tr í u
trò	tr ò
tròi	tr ò i
tròm	tr ò m
tròn	tr ò n
tròng	tr ò ng
tróc	tr ó c
trói	tr ó i
tróm	tr ó m
tróng	tr ó ng
trót	tr ó t
trô	tr ô
trôi	tr ô i
trôm	tr ô m
trôn	tr ô n
trông	tr ô ng
trõ	tr õ
trõm	tr õ m
trõn	tr õ n
trù	tr ù
trùi	tr ù i
trùm	tr ù m
trùn	tr ù n
trùng	tr ù ng
trú	tr ú
trúc	tr ú c
trúm	tr ú m
trúng	tr ú ng
trút	tr ú t
trăm	tr ă m
trăn	tr ă n
trăng	tr ă ng
trĩ	tr ĩ
trĩnh	tr ĩ nh
trĩu	tr ĩ u
trũi	tr ũ i
trũng	tr ũ ng
trơ	tr ơ
trơi	tr ơ i
trơn	tr ơ n
trư	tr ư
trưa	tr ư a
trưng	tr ư ng
trương	tr ươ ng
trước	tr ướ c
trướng	tr ướ ng
trườn	tr ườ n
trường	tr ườ ng
trưởng	tr ưở ng
trưỡng	tr ưỡ ng
trượng	tr ượ ng
trượt	tr ượ t
trạc	tr ạ c
trạch	tr ạ ch
trại	tr ạ i
trạm	tr ạ m
trạn	tr ạ n
trạng	tr ạ ng
trạnh	tr ạ nh
trạo	tr ạ o
trạy	tr ạ y
trả	tr ả
trải	tr ả i
trảm	tr ả m
trản	tr ả n
trảng	tr ả ng
trảnh	tr ả nh
trảo	tr ả o
trảu	tr ả u
trảy	tr ả y
trấn	tr ấ n
trấp	tr ấ p
trất	tr ấ t
trấu	tr ấ u
trầm	tr ầ m
trần	tr ầ n
trầu	tr ầ u
trầy	tr ầ y
trẩm	tr ẩ m
trẩn	tr ẩ n
trẩu	tr ẩ u
trẩy	tr ẩ y
trẫm	tr ẫ m
trậm	tr ậ m
trận	tr ậ n
trập	tr ậ p
trật	tr ậ t
trắc	tr ắ c
trắm	tr ắ m
trắng	tr ắ ng
trằm	tr ằ m
trằn	tr ằ n
trằng	tr ằ ng
trẳng	tr ẳ ng
trặc	tr ặ c
trặn	tr ặ n
trẹ	tr ẹ
trẹo	tr ẹ o
trẹt	tr ẹ t
trẻ	tr ẻ
trẻo	tr ẻ o
trẽ	tr ẽ
trẽn	tr ẽ n
trẽo	tr ẽ o
trếch	tr ế ch
trếnh	tr ế nh
trết	tr ế t
trếu	tr ế u
trề	tr ề
trển	tr ể n
trễ	tr ễ
trệ	tr ệ
trệch	tr ệ ch
trệt	tr ệ t
trệu	tr ệ u
trỉa	tr ỉ a
trị	tr ị
trịa	tr ị a
trịch	tr ị ch
trịn	tr ị n
trịnh	tr ị nh
trịt	tr ị t
trọ	tr ọ
trọc	tr ọ c
trọi	tr ọ i
trọn	tr ọ n
trọng	tr ọ ng
trọt	tr ọ t
trỏ	tr ỏ
trỏi	tr ỏ i
trỏng	tr ỏ ng
trố	tr ố
trốc	tr ố c
trối	tr ố i
trốn	tr ố n
trống	tr ố ng
trốt	tr ố t
trồ	tr ồ
trồi	tr ồ i
trồng	tr ồ ng
trổ	tr ổ
trổi	tr ổ i
trổng	tr ổ ng
trỗ	tr ỗ
trỗi	tr ỗ i
trộ	tr ộ
trội	tr ộ i
trộm	tr ộ m
trộn	tr ộ n
trộng	tr ộ ng
trớ	tr ớ
trới	tr ớ i
trớn	tr ớ n
trớp	tr ớ p
trớt	tr ớ t
trờ	tr ờ
trời	tr ờ i
trờn	tr ờ n
trở	tr ở
trợ	tr ợ
trợn	tr ợ n
trợt	tr ợ t
trụ	tr ụ
trụa	tr ụ a
trục	tr ụ c
trụi	tr ụ i
trụm	tr ụ m
trụn	tr ụ n
trụng	tr ụ ng
trụp	tr ụ p
trụt	tr ụ t
trụy	tr ụ y
trủ	tr ủ
trủng	tr ủ ng
trứ	tr ứ
trứng	tr ứ ng
trừ	tr ừ
trừa	tr ừ a
trừng	tr ừ ng
trừu	tr ừ u
trửng	tr ử ng
trữ	tr ữ
trự	tr ự
trực	tr ự c
tts	t t s
tu	t u
tua	t u a
tua vit	t u a v i t
tuabin	t u a b i n
tughrik	t u gh r i k
tui	t u i
tuinen	t u i n e n
tulokho	t u l o kh o
tum	t u m
tun	t u n
tung	t u ng
tuoi	t u o i
tupsa	t u p s a
tuy	t uy
tuya	t uy a
tuyn	t uy n
tuyên	t uyê n
tuyếc	t uyế c
tuyến	t uyế n
tuyết	t uyế t
tuyền	t uyề n
tuyển	t uyể n
tuyệt	t uyệ t
tuân	t uâ n
tuôcbin	t uô c b i n
tuôn	t uô n
tuông	t uô ng
tuý	t uý
tuých	t uý ch
tuýp	t uý p
tuýt	t uý t
tuấn	t uấ n
tuất	t uấ t
tuần	t uầ n
tuẫn	t uẫ n
tuế	t uế
tuếch	t uế ch
tuềnh	t uề nh
tuệ	t uệ
tuệch	t uệ ch
tuốc	t uố c
tuốc năng	t uố c n ă ng
tuốn	t uố n
tuốt	t uố t
tuồn	t uồ n
tuồng	t uồ ng
tuổi	t uổ i
tuộc	t uộ c
tuột	t uộ t
tuỳ	t uỳ
tuỵ	t uỵ
tuỷ	t uỷ
tw	t w
ty	t y
typn	t y p n
tà	t à
tài	t à i
tàm	t à m
tàn	t à n
tàng	t à ng
tành	t à nh
tào	t à o
tàu	t à u
tày	t à y
tá	t á
tác	t á c
tách	t á ch
tái	t á i
tám	t á m
tán	t á n
táng	t á ng
tánh	t á nh
táo	t á o
táp	t á p
tát	t á t
táu	t á u
táy	t á y
tâm	t â m
tân	t â n
tâng	t â ng
tâu	t â u
tây	t â y
tã	t ã
tãi	t ã i
tè	t è
tèm	t è m
tèn	t è n
tèng	t è ng
tèo	t è o
té	t é
téc	t é c
télons	t é l o n s
tém	t é m
tén	t é n
téo	t é o
tép	t é p
tét	t é t
tê	t ê
têm	t ê m
tên	t ê n
tênh	t ê nh
têt	t ê t
têtanôt	t ê t a n ô t
têu	t ê u
tì	t ì
tìm	t ì m
tìn	t ì n
tình	t ì nh
tí	t í
tía	t í a
tíc	t í c
tích	t í ch
tím	t í m
tín	t í n
tính	t í nh
típ	t í p
tít	t í t
tíu	t í u
tò	t ò
tòa	t òa
tòe	t ò e
tòi	t ò i
tòm	t ò m
tòn	t ò n
tòng	t ò ng
tòra	t ò r a
tòron	t ò r o n
tó	t ó
tóc	t ó c
tóe	t ó e
tói	t ó i
tóm	t ó m
tóp	t ó p
tót	t ó t
tô	t ô
tôi	t ô i
tôm	t ô m
tôn	t ô n
tông	t ô ng
tôtem	t ô t e m
tõm	t õ m
tù	t ù
tùa	t ù a
tùm	t ù m
tùng	t ù ng
tùy	t ù y
tú	t ú
túa	t ú a
túc	t ú c
túi	t ú i
túm	t ú m
túng	t ú ng
túp	t ú p
tút	t ú t
túy	t ú y
tý	t ý
tăcte	t ă c t e
tăcxi	t ă c x i
tăm	t ă m
tăn	t ă n
tặn t ă n 6	t ặ n t ă n
tăng	t ă ng
tăng xê	t ă ng x ê
tăngbo	t ă ng b o
tăngxin	t ă ng x i n
tđd	t đ d
tđh	t đ h
tĩ	t ĩ
tĩn	t ĩ n
tĩnh	t ĩ nh
tĩu	t ĩ u
tũm	t ũ m
tũn	t ũ n
tơ	t ơ
tơi	t ơ i
tơn	t ơ n
tơrơt	t ơ r ơ t
tơrưng	t ơ r ư ng
tư	t ư
tưa	t ư a
tưng	t ư ng
tươi	t ươ i
tươm	t ươ m
tương	t ươ ng
tước	t ướ c
tưới	t ướ i
tướn	t ướ n
tướng	t ướ ng
tướp	t ướ p
tướt	t ướ t
tườm	t ườ m
tường	t ườ ng
tườu	t ườ u
tưởi	t ưở i
tưởng	t ưở ng
tược	t ượ c
tượng	t ượ ng
tượp	t ượ p
tạ	t ạ
tạc	t ạ c
tạch	t ạ ch
tại	t ạ i
tạm	t ạ m
tạng	t ạ ng
tạnh	t ạ nh
tạo	t ạ o
tạp	t ạ p
tạt	t ạ t
tạy	t ạ y
tả	t ả
tải	t ả i
tản	t ả n
tảng	t ả ng
tảo	t ả o
tấc	t ấ c
tấm	t ấ m
tấn	t ấ n
tấp	t ấ p
tất	t ấ t
tấu	t ấ u
tấy	t ấ y
tầm	t ầ m
tần	t ầ n
tầng	t ầ ng
tầu	t ầ u
tầy	t ầ y
tẩm	t ẩ m
tẩn	t ẩ n
tẩu	t ẩ u
tẩy	t ẩ y
tậm	t ậ m
tận	t ậ n
tập	t ậ p
tật	t ậ t
tậu	t ậ u
tắc	t ắ c
tắm	t ắ m
tắn	t ắ n
tắp	t ắ p
tắt	t ắ t
tằm	t ằ m
tằn	t ằ n
tằng	t ằ ng
tẳn	t ẳ n
tặc	t ặ c
tặng	t ặ ng
tẹc	t ẹ c
tẹo	t ẹ o
tẹp	t ẹ p
tẹt	t ẹ t
tẻ	t ẻ
tẻm	t ẻ m
tẻo	t ẻ o
tẽ	t ẽ
tẽn	t ẽ n
tế	t ế
tếch	t ế ch
tết	t ế t
tếu	t ế u
tề	t ề
tềnh	t ề nh
tể	t ể
tểnh	t ể nh
tễ	t ễ
tễnh	t ễ nh
tệ	t ệ
tệch	t ệ ch
tệp	t ệ p
tỉ	t ỉ
tỉa	t ỉ a
tỉm	t ỉ m
tỉnh	t ỉ nh
tỉu	t ỉ u
tị	t ị
tịch	t ị ch
tịnh	t ị nh
tịt	t ị t
tịu	t ị u
tọ	t ọ
tọa	t ọa
tọc	t ọ c
tọng	t ọ ng
tọp	t ọ p
tọt	t ọ t
tỏ	t ỏ
tỏa	t ỏa
tỏe	t ỏ e
tỏi	t ỏ i
tỏm	t ỏ m
tỏng	t ỏ ng
tố	t ố
tốc	t ố c
tối	t ố i
tốn	t ố n
tống	t ố ng
tốp	t ố p
tốt	t ố t
tồ	t ồ
tồi	t ồ i
tồm	t ồ m
tồn	t ồ n
tồng	t ồ ng
tổ	t ổ
tổn	t ổ n
tổng	t ổ ng
tỗn	t ỗ n
tỗng	t ỗ ng
tộ	t ộ
tộc	t ộ c
tội	t ộ i
tộp	t ộ p
tột	t ộ t
tớ	t ớ
tới	t ớ i
tớn	t ớ n
tớp	t ớ p
tớt	t ớ t
tờ	t ờ
tời	t ờ i
tở	t ở
tởm	t ở m
tởn	t ở n
tợ	t ợ
tợn	t ợ n
tợp	t ợ p
tụ	t ụ
tục	t ụ c
tụi	t ụ i
tụm	t ụ m
tụng	t ụ ng
tụt	t ụ t
tụy	t ụ y
tủ	t ủ
tủa	t ủ a
tủi	t ủ i
tủm	t ủ m
tủn	t ủ n
tủng	t ủ ng
tủy	t ủ y
tứ	t ứ
tứa	t ứ a
tức	t ứ c
từ	t ừ
từa	t ừ a
từng	t ừ ng
tử	t ử
tửa	t ử a
tửng	t ử ng
tửu	t ử u
tự	t ự
tựa	t ự a
tựu	t ự u
tỳ	t ỳ
tỵ	t ỵ
tỷ	t ỷ
u	u
uar	u a r
ub	u b
ubnd	u b n d
ui	u i
um	u m
umo	u m o
un	u n
une	u n e
ung	u ng
upsilon	u p sil o n
urani	u r a n i
usd	u s d
uy	uy
uyn	uy n
uyên	uyê n
uyển	uyể n
uá	u á
uây	uâ y
uôm	uô m
uông	uô ng
uý	uý
uýt	uý t
uất	uấ t
uầy	uầ y
uẩn	uẩ n
uẩy	uẩ y
uế	uế
uể	uể
uốn	uố n
uống	uố ng
uổng	uổ ng
uột	uộ t
uỳnh	uỳ nh
uỵch	uỵ ch
uỷ	uỷ
va	v a
vac	v a c
vaccin	v a c c i n
vachet	v a ch e t
vacxin	v a c x i n
vagông	v a g ô ng
vai	v a i
vali	v a l i
valjean	v a l e a n
vals	v a l s
valse	v a l s e
vam	v a m
van	v a n
vang	v a ng
vanh	v a nh
vani	v a n i
vao	v a o
varenne	v a r e n n e
varie	v a r i e
varreau	v a r r e a u
varơi	v a r ơ i
vaselin	v a s e l i n
vat	v a t
vatise	v a t i s e
vatu	v a t u
vay	v a y
vazơlin	v a z ơ l i n
ve	v e
vecni	v e c n i
ven	v e n
veo	v e o
verlaine	v e r l a i n e
verst	v e r s t
vettông	v e t t ô ng
vetxi	v e t x i
vi	v i
via	v i a
vierge	v i e r g e
vierges	v i e r g e s
vigny	v i g n y
vin	v i n
vinh	v i nh
vinilông	v i n i l ô ng
viollia	v i o l l i a
violon	v i o l o n
violoncello	v i o l o n c e l l o
vit	v i t
viten	v i t e n
vitor	v i t o r
viêm	v iê m
viên	v iê n
viêng	v iê ng
viôlông	v i ô l ô ng
viôlôngxen	v i ô l ô ng x e n
viến	v iế n
viếng	v iế ng
viết	v iế t
viền	v iề n
viển	v iể n
viễn	v iễ n
việc	v iệ c
viện	v iệ n
việt	v iệ t
vn	v n
vo	v o
voa	v oa
voan	v oa n
voi	v o i
voleur	v o l e u r
volfram	v o l f r a m
vom	v o m
von	v o n
vonfram	v o n f r a m
vong	v o ng
vousavez	v o u s a v e z
voọc	v oọ c
vrai	v r a i
vraiment	v r a i m e n t
vre	v r e
vu	v u
vua	v u a
vui	v u i
vun	v u n
vung	v u ng
vuông	v uô ng
vuốt	v uố t
vuột	v uộ t
vv	v v
vy	v y
và	v à
vài	v à i
vàm	v à m
vàn	v à n
vàng	v à ng
vành	v à nh
vào	v à o
vày	v à y
vá	v á
vác	v á c
vách	v á ch
vái	v á i
ván	v á n
váng	v á ng
vánh	v á nh
váo	v á o
váp	v á p
vát	v á t
váy	v á y
vâm	v â m
vân	v â n
vâng	v â ng
vây	v â y
vã	v ã
vãi	v ã i
vãn	v ã n
vãng	v ã ng
vãnh	v ã nh
vè	v è
vèo	v è o
vé	v é
véc	v é c
vén	v é n
véo	v é o
vét	v é t
vê	v ê
vên	v ê n
vênh	v ê nh
vêu	v ê u
vì	v ì
ví	v í
vía	v í a
vích	v í ch
vính	v í nh
vít	v í t
víu	v í u
vò	v ò
vòi	v ò i
vòm	v ò m
vòmg	v ò m g
vòn	v ò n
vòng	v ò ng
vó	v ó
vóc	v ó c
vói	v ó i
vón	v ó n
vóng	v ó ng
vót	v ó t
vô	v ô
vô lăng	v ô l ă ng
vôi	v ô i
vôn	v ô n
vông	v ô ng
võ	v õ
võnc	v õ n c
võng	v õ ng
vù	v ù
vùa	v ù a
vùi	v ù i
vùn	v ù n
vùng	v ù ng
vú	v ú
vúc	v ú c
vút	v ú t
văn	v ă n
văng	v ă ng
vĩ	v ĩ
vĩnh	v ĩ nh
vũ	v ũ
vũm	v ũ m
vũng	v ũ ng
vơ	v ơ
vơi	v ơ i
vưng	v ư ng
vưom	v ư o m
vưu	v ư u
vươn	v ươ n
vương	v ươ ng
vướng	v ướ ng
vườn	v ườ n
vưởng	v ưở ng
vược	v ượ c
vượn	v ượ n
vượng	v ượ ng
vượt	v ượ t
vạ	v ạ
vạc	v ạ c
vạch	v ạ ch
vại	v ạ i
vạm	v ạ m
vạn	v ạ n
vạng	v ạ ng
vạnh	v ạ nh
vạp	v ạ p
vạt	v ạ t
vạy	v ạ y
vả	v ả
vải	v ả i
vảng	v ả ng
vảnh	v ả nh
vảy	v ả y
vấn	v ấ n
vấp	v ấ p
vất	v ấ t
vấu	v ấ u
vấy	v ấ y
vần	v ầ n
vầng	v ầ ng
vầu	v ầ u
vầy	v ầ y
vẩn	v ẩ n
vẩu	v ẩ u
vẩy	v ẩ y
vẫn	v ẫ n
vẫy	v ẫ y
vậm	v ậ m
vận	v ậ n
vập	v ậ p
vật	v ậ t
vậy	v ậ y
vắc	v ắ c
vắn	v ắ n
vắng	v ắ ng
vắt	v ắ t
vằm	v ằ m
vằn	v ằ n
vằng	v ằ ng
vẳng	v ẳ ng
vặc	v ặ c
vặn	v ặ n
vặt	v ặ t
vẹc	v ẹ c
vẹm	v ẹ m
vẹn	v ẹ n
vẹo	v ẹ o
vẹt	v ẹ t
vẻ	v ẻ
vẻn	v ẻ n
vẻo	v ẻ o
vẽ	v ẽ
vế	v ế
vếch	v ế ch
vết	v ế t
vếu	v ế u
về	v ề
vền	v ề n
vều	v ề u
vểnh	v ể nh
vệ	v ệ
vện	v ệ n
vệt	v ệ t
vỉ	v ỉ
vỉa	v ỉ a
vị	v ị
vịm	v ị m
vịn	v ị n
vịnh	v ị nh
vịt	v ị t
vọ	v ọ
vọc	v ọ c
vọi	v ọ i
vọng	v ọ ng
vọp	v ọ p
vọrg	v ọ r g
vọt	v ọ t
vỏ	v ỏ
vỏn	v ỏ n
vỏng	v ỏ ng
vố	v ố
vốc	v ố c
vối	v ố i
vốn	v ố n
vống	v ố ng
vồ	v ồ
vồi	v ồ i
vồn	v ồ n
vồng	v ồ ng
vổ	v ổ
vổng	v ổ ng
vỗ	v ỗ
vội	v ộ i
vớ	v ớ
với	v ớ i
vớt	v ớ t
vờ	v ờ
vời	v ờ i
vờn	v ờ n
vở	v ở
vởn	v ở n
vỡ	v ỡ
vợ	v ợ
vợi	v ợ i
vợt	v ợ t
vụ	v ụ
vục	v ụ c
vụn	v ụ n
vụng	v ụ ng
vụt	v ụ t
vủn	v ủ n
vủng	v ủ ng
vức	v ứ c
vứt	v ứ t
vừa	v ừ a
vừng	v ừ ng
vửng	v ử ng
vữa	v ữ a
vững	v ữ ng
vựa	v ự a
vực	v ự c
vựng	v ự ng
vỹ	v ỹ
wh	w h
whilsky	w h i l s k y
wi	w i
won	w o n
wushu	w u sh u
xa	x a
xalông	x a l ô ng
xam	x a m
xamôva	x a m ô v a
xan	x a n
xang	x a ng
xanh	x a nh
xanhđica	x a nh đ i c a
xao	x a o
xatanh	x a t a nh
xay	x a y
xe	x e
xem	x e m
xemina	x e m i n a
xen	x e n
xeng	x e ng
xenlulo	x e n l u l o
xenti	x e n t i
xeo	x e o
xhcn	x h c n
xi	x i
xi măng	x i m ă ng
xia	x i a
xier	x i e r
xifông	x i f ô ng
xilanh	x i l a nh
xilip	x i l i p
xim	x i m
xin	x i n
xing	x i ng
xinh	x i nh
xinhan	x i nh a n
xiphông	x i ph ô ng
xit	x i t
xita	x i t a
xiê	x iê
xiêm	x iê m
xiên	x iê n
xiên2	x iê n
xiêu	x iê u
xiếc	x iế c
xiết	x iế t
xiếu	x iế u
xiềng	x iề ng
xiểm	x iể m
xiển	x iể n
xiểng	x iể ng
xki	x k i
xn	x n
xo	x o
xoa	x oa
xoai	x oa i
xoan	x oa n
xoang	x oa ng
xoay	x oa y
xoe	x oe
xoen	x oe n
xoi	x o i
xolenoit	x o l e n o i t
xom	x o m
xon	x o n
xonat	x o n a t
xong	x o ng
xoong	x oo ng
xoà	x oà
xoài	x oà i
xoàm	x oà m
xoàn	x oà n
xoàng	x oà ng
xoành	x oà nh
xoá	x oá
xoát	x oá t
xoáy	x oá y
xoã	x oã
xoè	x oè
xoèn	x oè n
xoét	x oé t
xoóc	x oó c
xoăn	x oă n
xoạc	x oạ c
xoạch	x oạ ch
xoạng	x oạ ng
xoạt	x oạ t
xoả	x oả
xoải	x oả i
xoảng	x oả ng
xoắn	x oắ n
xoẳn	x oẳ n
xoẹ	x oẹ
xoẹt	x oẹ t
xoẻng	x oẻ ng
xpen	x p e n
xphan	x ph a n
xpi	x p i
xta	x t a
xte	x t e
xten	x t e n
xtiêng	x t iê ng
xtrép	x tr é p
xtrích	x tr í ch
xtrết	x tr ế t
xtíc	x t í c
xtăng	x t ă ng
xtốp	x t ố p
xu	x u
xua	x u a
xuchiêng	x u ch iê ng
xui	x u i
xum	x u m
xun	x u n
xung	x u ng
xupap	x u p a p
xuy	x uy
xuya	x uy a
xuynh	x uy nh
xuyên	x uyê n
xuyến	x uyế n
xuyết	x uyế t
xuâm	x uâ m
xuân	x uâ n
xuând	x uâ n d
xuây	x uâ y
xuê	x uê
xuôi	x uô i
xuông	x uô ng
xuý	x uý
xuýt	x uý t
xuất	x uấ t
xuẩn	x uẩ n
xuề	x uề
xuềnh	x uề nh
xuể	x uể
xuệch	x uệ ch
xuống	x uố ng
xuồng	x uồ ng
xuổng	x uổ ng
xuộm	x uộ m
xuỳ	x uỳ
xuỵt	x uỵ t
xy	x y
xà	x à
xài	x à i
xàm	x à m
xàng	x à ng
xành	x à nh
xào	x à o
xàu	x à u
xá	x á
xác	x á c
xách	x á ch
xái	x á i
xám	x á m
xán	x á n
xáng	x á ng
xáo	x á o
xáp	x á p
xát	x á t
xáu	x á u
xáy	x á y
xâm	x â m
xâu	x â u
xây	x â y
xã	x ã
xè	x è
xèn	x è n
xèng	x è ng
xèo	x è o
xé	x é
xéc	x é c
xém	x é m
xén	x é n
xéo	x é o
xép	x é p
xét	x é t
xê	x ê
xên	x ê n
xênh	x ê nh
xêri	x ê r i
xêu	x ê u
xì	x ì
xì3	x ì
xìa	x ì a
xình	x ì nh
xìu	x ì u
xí	x í
xía	x í a
xích	x í ch
xín	x í n
xính	x í nh
xít	x í t
xíu	x í u
xòa	x òa
xòe	x ò e
xòm	x ò m
xòng	x ò ng
xó	x ó
xóa	x óa
xóc	x ó c
xói	x ó i
xóm	x ó m
xón	x ó n
xóp	x ó p
xót	x ó t
xô	x ô
xôi	x ô i
xôm	x ô m
xôn	x ô n
xônat	x ô n a t
xông	x ô ng
xôviêt	x ô v iê t
xõa	x õ a
xõm	x õ m
xõng	x õ ng
xù	x ù
xùa	x ù a
xùi	x ù i
xùm	x ù m
xùng	x ù ng
xùy	x ù y
xú	x ú
xúa	x ú a
xúc	x ú c
xúi	x ú i
xúm	x ú m
xúng	x ú ng
xúp	x ú p
xút	x ú t
xúy	x ú y
xýt	x ý t
xăm	x ă m
xăng	x ă ng
xĩnh	x ĩ nh
xũ	x ũ
xơ	x ơ
xơcua	x ơ c u a
xơi	x ơ i
xơm	x ơ m
xơn	x ơ n
xưa	x ư a
xưng	x ư ng
xương	x ươ ng
xước	x ướ c
xướng	x ướ ng
xười	x ườ i
xường	x ườ ng
xưởng	x ưở ng
xược	x ượ c
xượi	x ượ i
xạ	x ạ
xạc	x ạ c
xạch	x ạ ch
xạm	x ạ m
xạo	x ạ o
xạp	x ạ p
xạu	x ạ u
xả	x ả
xải	x ả i
xảm	x ả m
xảnh	x ả nh
xảo	x ả o
xảu	x ả u
xảy	x ả y
xấc	x ấ c
xấp	x ấ p
xấu	x ấ u
xầm	x ầ m
xầu	x ầ u
xẩm	x ẩ m
xẩn	x ẩ n
xẩu	x ẩ u
xẩy	x ẩ y
xậm	x ậ m
xập	x ậ p
xắc	x ắ c
xắm	x ắ m
xắn	x ắ n
xắng	x ắ ng
xắp	x ắ p
xắt	x ắ t
xằng	x ằ ng
xẵng	x ẵ ng
xẹ	x ẹ
xẹc	x ẹ c
xẹo	x ẹ o
xẹp	x ẹ p
xẹt	x ẹ t
xẻ	x ẻ
xẻn	x ẻ n
xẻng	x ẻ ng
xẻo	x ẻ o
xẽo	x ẽ o
xế	x ế
xếch	x ế ch
xếp	x ế p
xề	x ề
xềm	x ề m
xềnh	x ề nh
xều	x ề u
xể	x ể
xệ	x ệ
xệch	x ệ ch
xệp	x ệ p
xệt	x ệ t
xệu	x ệ u
xỉ	x ỉ
xỉa	x ỉ a
xỉn	x ỉ n
xỉnh	x ỉ nh
xỉu	x ỉ u
xị	x ị
xịch	x ị ch
xịn	x ị n
xịt	x ị t
xịu	x ị u
xọ	x ọ
xọc	x ọ c
xọe	x ọ e
xọp	x ọ p
xỏ	x ỏ
xỏa	x ỏa
xỏng	x ỏ ng
xố	x ố
xốc	x ố c
xối	x ố i
xốn	x ố n
xống	x ố ng
xốp	x ố p
xốt	x ố t
xồ	x ồ
xồm	x ồ m
xồn	x ồ n
xồng	x ồ ng
xổ	x ổ
xổi	x ổ i
xổm	x ổ m
xổn	x ổ n
xổng	x ổ ng
xộc	x ộ c
xộn	x ộ n
xộp	x ộ p
xớ	x ớ
xới	x ớ i
xớn	x ớ n
xớp	x ớ p
xớt	x ớ t
xờ	x ờ
xờm	x ờ m
xở	x ở
xởi	x ở i
xởn	x ở n
xỡ	x ỡ
xợt	x ợ t
xụ	x ụ
xục	x ụ c
xụi	x ụ i
xụng	x ụ ng
xụp	x ụ p
xụt	x ụ t
xủ	x ủ
xứ	x ứ
xức	x ứ c
xứng	x ứ ng
xừ	x ừ
xử	x ử
xửa	x ử a
xửng	x ử ng
xự	x ự
xực	x ự c
y	y
yang	y a ng
yd	y d
yver	y v e r
yêm	yê m
yên	yê n
yêng	yê ng
yêu	yê u
yếm	yế m
yến	yế n
yết	yế t
yếu	yế u
yểm	yể m
yểng	yể ng
yểu	yể u
za	z a
zeenat	z e e n a t
ziczac	z i c z a c
zin	z i n
zn	z n
zuoh	z u o h
zích	z í ch
zôn	z ô n
zốt	z ố t
à	à
àn	à n
ành	à nh
ào	à o
á	á
ác	á c
ách	á ch
ái	á i
ám	á m
áme	á m e
án	á n
áng	á ng
ánh	á nh
áo	á o
áp	á p
át	á t
áy	á y
â	â
âm	â m
ân	â n
âu	â u
ây	â y
ã	ã
è	è
èng	è ng
èo	è o
é	é
éc	é c
éducation	é d u c a t i o n
ém	é m
én	é n
éo	é o
ép	é p
épis	é p i s
épouser	é p o u s e r
ét	é t
évent	é v e n t
ê	ê
êbur	ê b u r
êcu	ê c u
êga	ê g a
êke	ê k e
êkip	ê k i p
êm	ê m
êning	ê n i ng
êpan	ê p a n
êta	ê t a
être	ê tr e
êu	ê u
êđê	ê đ ê
ì	ì
ìn	ì n
ình	ì nh
í	í
ích	í ch
ín	í n
ít	í t
íu	í u
ò	ò
òa	òa
òi	ò i
òm	ò m
òn	ò n
òng	ò ng
ó	ó
óc	ó c
óe	ó e
ói	ó i
ón	ó n
óng	ó ng
óp	ó p
ót	ó t
ô	ô
ô cái	ô c á i
ôboa	ô b oa
ôcái	ô c á i
ôhay	ô h a y
ôi	ô i
ôkìa	ô k ì a
ôliu	ô l i u
ôm	ô m
ôn	ô n
ông	ô ng
ông nửa	ô ng n ử a
ôngcàng	ô ng c à ng
ôngnửa	ô ng n ử a
ôplêt	ô p l ê t
ôten	ô t e n
ôtôcla	ô t ô c l a
ôtômat	ô t ô m a t
ôvăng	ô v ă ng
õbăng	õ b ă ng
õng	õ ng
ù	ù
ùa	ù a
ùm	ù m
ùn	ù n
ùng	ù ng
ú	ú
úa	ú a
úc	ú c
úi	ú i
úm	ú m
úng	ú ng
úp	ú p
út	ú t
úy	ú y
ý	ý
ý hẳn	ý h ẳ n
ý tôi	ý t ô i
ýhẳn	ý h ẳ n
ýtôi	ý t ô i
ă	ă
ăccoóc	ă c c oó c
ăcquy	ă c q uy
ăm	ă m
ăn	ă n
ăng	ă ng
ăngten	ă ng t e n
đ	đ
đa	đ a
đai	đ a i
đam	đ a m
đan	đ a n
đang	đ a ng
đanh	đ a nh
đantou	đ a n t o u
đao	đ a o
đau	đ a u
đay	đ a y
đađa	đ a đ a
đe	đ e
đeca	đ e c a
đem	đ e m
đen	đ e n
đeng	đ e ng
đenta	đ e n t a
đeo	đ e o
đexi	đ e x i
đexiben	đ e x i b e n
đi	đ i
đia	đ i a
điezen	đ i e z e n
đii	đ i i
đimột	đ i m ộ t
đin	đ i n
đinamit	đ i n a m i t
đinamo	đ i n a m o
đinh	đ i nh
đinh’	đ i nh
điop	đ i o p
điot	đ i o t
đip	đ i p
điu	đ i u
đivăng	đ i v ă ng
điên	đ iê n
điêng	đ iê ng
điêu	đ iê u
điếc	đ iế c
điếm	đ iế m
điến	đ iế n
điếng	đ iế ng
điếu	đ iế u
điềm	đ iề m
điền	đ iề n
điều	đ iề u
điểm	đ iể m
điển	đ iể n
điểu	đ iể u
điệm	đ iệ m
điện	đ iệ n
điệp	đ iệ p
điệu	đ iệ u
đkz	đ k z
đo	đ o
đoa	đ oa
đoan	đ oa n
đoi	đ o i
đom	đ o m
đon	đ o n
đong	đ o ng
đoài	đ oà i
đoàn	đ oà n
đoàng	đ oà ng
đoành	đ oà nh
đoá	đ oá
đoác	đ oá c
đoái	đ oá i
đoán	đ oá n
đoãng	đ oã ng
đoạ	đ oạ
đoạn	đ oạ n
đoạt	đ oạ t
đoản	đ oả n
đoảng	đ oả ng
đph	đ ph
đrin	đ r i n
đrá	đ r á
đrát	đ r á t
đríc	đ r í c
đrông	đ r ô ng
đt	đ t
đu	đ u
đua	đ u a
đui	đ u i
đum	đ u m
đumđum	đ u m đ u m
đun	đ u n
đung	đ u ng
đup	đ u p
đura	đ u r a
đuy	đ uy
đuya	đ uy a
đuyra	đ uy r a
đuôi	đ uô i
đuôn	đ uô n
đuông	đ uô ng
đuềnh	đ uề nh
đuốc	đ uố c
đuối	đ uố i
đuống	đ uố ng
đuồn	đ uồ n
đuổi	đ uổ i
đuỗn	đ uỗ n
đuột	đ uộ t
đuợc	đ uợ c
đà	đ à
đài	đ à i
đàm	đ à m
đàn	đ à n
đàng	đ à ng
đành	đ à nh
đào	đ à o
đày	đ à y
đá	đ á
đác	đ á c
đách	đ á ch
đái	đ á i
đám	đ á m
đán	đ á n
đáng	đ á ng
đánh	đ á nh
đáo	đ á o
đáp	đ á p
đát	đ á t
đáu	đ á u
đáy	đ á y
đâm	đ â m
đâng	đ â ng
đâu	đ â u
đây	đ â y
đấy	đ ấ y
đã	đ ã
đãi	đ ã i
đãng	đ ã ng
đãy	đ ã y
đè	đ è
đèm	đ è m
đèn	đ è n
đèo	đ è o
đé	đ é
đéc	đ é c
đém	đ é m
đéo	đ é o
đét	đ é t
đê	đ ê
đêm	đ ê m
đên	đ ê n
đênh	đ ê nh
đêu	đ ê u
đì	đ ì
đìa	đ ì a
đìn	đ ì n
đình	đ ì nh
đìu	đ ì u
đí	đ í
đía	đ í a
đích	đ í ch
đính	đ í nh
đíp	đ í p
đít	đ í t
đò	đ ò
đòi	đ ò i
đòm	đ ò m
đòn	đ ò n
đòng	đ ò ng
đó	đ ó
đóa	đ óa
đóan	đ óa n
đóc	đ ó c
đói	đ ó i
đóm	đ ó m
đón	đ ó n
đóng	đ ó ng
đóp	đ ó p
đót	đ ó t
đô	đ ô
đôi	đ ô i
đôm	đ ô m
đôn	đ ô n
đông	đ ô ng
đõ	đ õ
đù	đ ù
đùa	đ ù a
đùi	đ ù i
đùm	đ ù m
đùn	đ ù n
đùng	đ ù ng
đú	đ ú
đúa	đ ú a
đúc	đ ú c
đúm	đ ú m
đúng	đ ú ng
đúp	đ ú p
đút	đ ú t
đăm	đ ă m
đăn	đ ă n
đăng	đ ă ng
đăngten	đ ă ng t e n
đĩ	đ ĩ
đĩa	đ ĩ a
đĩnh	đ ĩ nh
đũa	đ ũ a
đũi	đ ũ i
đũng	đ ũ ng
đơ	đ ơ
đơm	đ ơ m
đơn	đ ơ n
đưa	đ ư a
đưng	đ ư ng
đường	đ ườ ng
đươc	đ ươ c
đương	đ ươ ng
được	đ ượ c
đước	đ ướ c
đướu	đ ướ u
đười	đ ườ i
đườn	đ ườ n
đường	đ ườ ng
được	đ ượ c
đượi	đ ượ i
đượm	đ ượ m
đạc	đ ạ c
đạch	đ ạ ch
đại	đ ạ i
đạm	đ ạ m
đạn	đ ạ n
đạo	đ ạ o
đạp	đ ạ p
đạt	đ ạ t
đả	đ ả
đảm	đ ả m
đản	đ ả n
đảng	đ ả ng
đảnh	đ ả nh
đảo	đ ả o
đảy	đ ả y
đấm	đ ấ m
đấng	đ ấ ng
đất	đ ấ t
đấu	đ ấ u
đấy	đ ấ y
đầm	đ ầ m
đần	đ ầ n
đầu	đ ầ u
đầy	đ ầ y
đẩu	đ ẩ u
đẩy	đ ẩ y
đẫm	đ ẫ m
đẫn	đ ẫ n
đẫy	đ ẫ y
đậm	đ ậ m
đận	đ ậ n
đập	đ ậ p
đật	đ ậ t
đậu	đ ậ u
đậy	đ ậ y
đắc	đ ắ c
đắm	đ ắ m
đắn	đ ắ n
đắng	đ ắ ng
đắp	đ ắ p
đắt	đ ắ t
đằm	đ ằ m
đằng	đ ằ ng
đẳng	đ ẳ ng
đẵm	đ ẵ m
đẵn	đ ẵ n
đẵng	đ ẵ ng
đặc	đ ặ c
đặm	đ ặ m
đặn	đ ặ n
đặng	đ ặ ng
đặt	đ ặ t
đẹn	đ ẹ n
đẹp	đ ẹ p
đẹt	đ ẹ t
đẻ	đ ẻ
đẽ	đ ẽ
đẽo	đ ẽ o
đế	đ ế
đếch	đ ế ch
đếm	đ ế m
đến	đ ế n
đề	đ ề
đềm	đ ề m
đền	đ ề n
đềnh	đ ề nh
đều	đ ề u
để	đ ể
đểm	đ ể m
đểnh	đ ể nh
đểu	đ ể u
đễ	đ ễ
đễn	đ ễ n
đễnh	đ ễ nh
đệ	đ ệ
đệm	đ ệ m
đỉa	đ ỉ a
đỉnh	đ ỉ nh
địa	đ ị a
địch	đ ị ch
định	đ ị nh
địt	đ ị t
địu	đ ị u
đọ	đ ọ
đọa	đ ọa
đọc	đ ọ c
đọi	đ ọ i
đọn	đ ọ n
đọng	đ ọ ng
đọp	đ ọ p
đọt	đ ọ t
đỏ	đ ỏ
đỏm	đ ỏ m
đỏng	đ ỏ ng
đố	đ ố
đốc	đ ố c
đối	đ ố i
đốm	đ ố m
đốn	đ ố n
đống	đ ố ng
đốp	đ ố p
đốt	đ ố t
đồ	đ ồ
đồi	đ ồ i
đồm	đ ồ m
đồn	đ ồ n
đồng	đ ồ ng
đổ	đ ổ
đổi	đ ổ i
đổng	đ ổ ng
đỗ	đ ỗ
đỗi	đ ỗ i
độ	đ ộ
độc	đ ộ c
đội	đ ộ i
độn	đ ộ n
động	đ ộ ng
độp	đ ộ p
đột	đ ộ t
đớ	đ ớ
đới	đ ớ i
đớn	đ ớ n
đớp	đ ớ p
đớt	đ ớ t
đờ	đ ờ
đời	đ ờ i
đờm	đ ờ m
đờn	đ ờ n
đởm	đ ở m
đởn	đ ở n
đỡ	đ ỡ
đợ	đ ợ
đợi	đ ợ i
đợp	đ ợ p
đợt	đ ợ t
đụ	đ ụ
đục	đ ụ c
đụi	đ ụ i
đụn	đ ụ n
đụng	đ ụ ng
đụp	đ ụ p
đụt	đ ụ t
đủ	đ ủ
đủi	đ ủ i
đủng	đ ủ ng
đứ	đ ứ
đứa	đ ứ a
đức	đ ứ c
đứng	đ ứ ng
đứt	đ ứ t
đừ	đ ừ
đừa	đ ừ a
đừng	đ ừ ng
đử	đ ử
đực	đ ự c
đựng	đ ự ng
ĩ	ĩ
ĩnh	ĩ nh
ơ	ơ
ơi	ơ i
ơn	ơ n
ơristic	ơ r i s t i c
ư	ư
ưa	ư a
ưng	ư ng
ưu	ư u
ươi	ươ i
ươm	ươ m
ươn	ươ n
ương	ươ ng
ước	ướ c
ướm	ướ m
ướp	ướ p
ướt	ướ t
ườn	ườ n
ưỡn	ưỡ n
ược	ượ c
ạ	ạ
ạch	ạ ch
ại	ạ i
ạm	ạ m
ạnh	ạ nh
ạo	ạ o
ạt	ạ t
ả	ả
ải	ả i
ảm	ả m
ảng	ả ng
ảnh	ả nh
ảo	ả o
ấm	ấ m
ấn	ấ n
ấp	ấ p
ất	ấ t
ấu	ấ u
ấy	ấ y
ầm	ầ m
ầng	ầ ng
ầu	ầ u
ầy	ầ y
ẩm	ẩ m
ẩn	ẩ n
ẩng	ẩ ng
ẩu	ẩ u
ẩy	ẩ y
ẫm	ẫ m
ậc	ậ c
ậm	ậ m
ập	ậ p
ậu	ậ u
ắc	ắ c
ắng	ắ ng
ắp	ắ p
ắt	ắ t
ằng	ằ ng
ẳng	ẳ ng
ẵm	ẵ m
ặc	ặ c
ẹ	ẹ
ẹc	ẹ c
ẹo	ẹ o
ẹp	ẹ p
ẹt	ẹ t
ẻn	ẻ n
ẻo	ẻ o
ẽo	ẽ o
ế	ế
ếch	ế ch
ếm	ế m
ến	ế n
ếp	ế p
ề	ề
ềnh	ề nh
ể	ể
ễng	ễ ng
ễnh	ễ nh
ệ	ệ
ệch	ệ ch
ện	ệ n
ệnh	ệ nh
ệp	ệ p
ệt	ệ t
ỉ	ỉ
ỉa	ỉ a
ỉm	ỉ m
ỉn	ỉ n
ỉu	ỉ u
ị	ị
ịch	ị ch
ịn	ị n
ịnh	ị nh
ịt	ị t
ọ	ọ
ọc	ọ c
ọe	ọ e
ọi	ọ i
ọp	ọ p
ọt	ọ t
ỏ	ỏ
ỏc	ỏ c
ỏe	ỏ e
ỏi	ỏ i
ỏm	ỏ m
ỏn	ỏ n
ỏng	ỏ ng
ố	ố
ốc	ố c
ối	ố i
ốm	ố m
ống	ố ng
ốp	ố p
ốt	ố t
ồ	ồ
ồi	ồ i
ồm	ồ m
ồn	ồ n
ồng	ồ ng
ổ	ổ
ổi	ổ i
ổm	ổ m
ổn	ổ n
ổng	ổ ng
ộ	ộ
ộc	ộ c
ộn	ộ n
ộng	ộ ng
ộp	ộ p
ớ	ớ
ới	ớ i
ớm	ớ m
ớn	ớ n
ớt	ớ t
ờ	ờ
ờ thế	ờ th ế
ời	ờ i
ở	ở
ở nhà	ở nh à
ở đâu	ở đ â u
ỡm	ỡ m
ợ	ợ
ợi	ợ i
ợt	ợ t
ụ	ụ
ụa	ụ a
ục	ụ c
ụp	ụ p
ụt	ụ t
ủ	ủ
ủa	ủ a
ủi	ủ i
ủn	ủ n
ủng	ủ ng
ủy	ủ y
ứ	ứ
ứa	ứ a
ức	ứ c
ứng	ứ ng
ừ	ừ
ử	ử
ửng	ử ng
ựa	ự a
ực	ự c
ỳ	ỳ
ỷ	ỷ
ỹ	ỹ
